,yr_range,sec_unique,year1,year2,n2_inflow,agi_inflow,n2_outflow,agi_outflow,n2_net,agi_net
0,1516,"Alachua County, FL",2015.0,2016.0,241,9280000,140,4519000,101,4761000
1,1516,"Alameda County, CA",2015.0,2016.0,395,18339000,439,19548000,-44,-1209000
2,1516,"Albany County, NY",2015.0,2016.0,37,1266000,37,1065000,0,201000
3,1516,"Alexandria city, VA",2015.0,2016.0,107,6278000,99,5410000,8,868000
4,1516,"Allegheny County, PA",2015.0,2016.0,494,17845000,334,11833000,160,6012000
5,1516,"Anderson County, SC",2015.0,2016.0,37,1348000,40,969000,-3,379000
6,1516,"Anne Arundel County, MD",2015.0,2016.0,199,5096000,138,3544000,61,1552000
7,1516,"Arapahoe County, CO",2015.0,2016.0,289,11250000,222,7250000,67,4000000
8,1516,"Arlington County, VA",2015.0,2016.0,139,10477000,143,8126000,-4,2351000
9,1516,"Baldwin County, GA",2015.0,2016.0,34,493000,52,453000,-18,40000
10,1516,"Baltimore County, MD",2015.0,2016.0,273,6832000,177,6622000,96,210000
11,1516,"Baltimore city, MD",2015.0,2016.0,311,11082000,192,5861000,119,5221000
12,1516,"Barrow County, GA",2015.0,2016.0,1406,31970000,2589,59931000,-1183,-27961000
13,1516,"Bartow County, GA",2015.0,2016.0,1478,32422000,2153,48423000,-675,-16001000
14,1516,"Bay County, FL",2015.0,2016.0,188,5477000,225,8713000,-37,-3236000
15,1516,"Beaufort County, SC",2015.0,2016.0,255,9677000,284,30182000,-29,-20505000
16,1516,"Bell County, TX",2015.0,2016.0,40,500000,53,704000,-13,-204000
17,1516,"Benton County, AR",2015.0,2016.0,69,4349000,45,4970000,24,-621000
18,1516,"Bergen County, NJ",2015.0,2016.0,459,30681000,150,7564000,309,23117000
19,1516,"Berkeley County, SC",2015.0,2016.0,75,2040000,85,2948000,-10,-908000
20,1516,"Bexar County, TX",2015.0,2016.0,423,13961000,420,11110000,3,2851000
21,1516,"Bibb County, GA",2015.0,2016.0,1238,29095000,702,14647000,536,14448000
22,1516,"Boulder County, CO",2015.0,2016.0,35,1843000,58,3852000,-23,-2009000
23,1516,"Brevard County, FL",2015.0,2016.0,253,9709000,294,11266000,-41,-1557000
24,1516,"Bronx County, NY",2015.0,2016.0,781,11919000,271,2692000,510,9227000
25,1516,"Broward County, FL",2015.0,2016.0,2514,61938000,1669,80334000,845,-18396000
26,1516,"Bulloch County, GA",2015.0,2016.0,270,5448000,172,3524000,98,1924000
27,1516,"Buncombe County, NC",2015.0,2016.0,161,5173000,236,12677000,-75,-7504000
28,1516,"Butts County, GA",2015.0,2016.0,380,6246000,558,11948000,-178,-5702000
29,1516,"Carroll County, GA",2015.0,2016.0,1737,35826000,2089,41278000,-352,-5452000
30,1516,"Charleston County, SC",2015.0,2016.0,433,15830000,567,29279000,-134,-13449000
31,1516,"Chatham County, GA",2015.0,2016.0,1478,35180000,1054,35617000,424,-437000
32,1516,"Chester County, PA",2015.0,2016.0,80,3852000,46,3340000,34,512000
33,1516,"Chesterfield County, VA",2015.0,2016.0,65,3707000,38,847000,27,2860000
34,1516,"Clark County, NV",2015.0,2016.0,505,15686000,526,21026000,-21,-5340000
35,1516,"Clarke County, GA",2015.0,2016.0,1251,35240000,1006,26333000,245,8907000
36,1516,"Clay County, FL",2015.0,2016.0,51,1146000,36,719000,15,427000
37,1516,"Collier County, FL",2015.0,2016.0,47,4471000,91,15929000,-44,-11458000
38,1516,"Collin County, TX",2015.0,2016.0,429,16503000,569,25628000,-140,-9125000
39,1516,"Columbia County, GA",2015.0,2016.0,378,14780000,309,8684000,69,6096000
40,1516,"Contra Costa County, CA",2015.0,2016.0,213,22915000,204,9041000,9,13874000
41,1516,"Cook County, IL",2015.0,2016.0,2778,102971000,1456,58853000,1322,44118000
42,1516,"Coweta County, GA",2015.0,2016.0,2539,84303000,3538,105478000,-999,-21175000
43,1516,"Cumberland County, NC",2015.0,2016.0,318,6056000,228,3572000,90,2484000
44,1516,"Cuyahoga County, OH",2015.0,2016.0,572,15989000,339,11963000,233,4026000
45,1516,"Dallas County, TX",2015.0,2016.0,919,38593000,1143,63207000,-224,-24614000
46,1516,"Dane County, WI",2015.0,2016.0,60,1529000,39,912000,21,617000
47,1516,"Davidson County, TN",2015.0,2016.0,871,31640000,789,43440000,82,-11800000
48,1516,"Dawson County, GA",2015.0,2016.0,655,16725000,1064,45997000,-409,-29272000
49,1516,"Delaware County, PA",2015.0,2016.0,69,2306000,35,2202000,34,104000
50,1516,"Denton County, TX",2015.0,2016.0,214,9690000,329,16430000,-115,-6740000
51,1516,"Denver County, CO",2015.0,2016.0,303,16821000,442,25978000,-139,-9157000
52,1516,"District of Columbia, DC",2015.0,2016.0,499,25148000,472,26826000,27,-1678000
53,1516,"Dougherty County, GA",2015.0,2016.0,563,9303000,298,4605000,265,4698000
54,1516,"DuPage County, IL",2015.0,2016.0,238,15923000,134,8319000,104,7604000
55,1516,"Durham County, NC",2015.0,2016.0,360,13218000,299,10142000,61,3076000
56,1516,"Duval County, FL",2015.0,2016.0,1418,36598000,1300,43391000,118,-6793000
57,1516,"East Baton Rouge Parish, LA",2015.0,2016.0,294,6155000,262,5364000,32,791000
58,1516,"El Paso County, CO",2015.0,2016.0,233,6068000,269,6957000,-36,-889000
59,1516,"Erie County, NY",2015.0,2016.0,112,2297000,37,1651000,75,646000
60,1516,"Escambia County, FL",2015.0,2016.0,242,6033000,256,6737000,-14,-704000
61,1516,"Essex County, NJ",2015.0,2016.0,629,17393000,192,4276000,437,13117000
62,1516,"Fairfax County, VA",2015.0,2016.0,606,28226000,534,23283000,72,4943000
63,1516,"Fairfield County, CT",2015.0,2016.0,314,22093000,198,16629000,116,5464000
64,1516,"Floyd County, GA",2015.0,2016.0,395,11339000,444,12050000,-49,-711000
65,1516,"Fort Bend County, TX",2015.0,2016.0,182,7066000,241,8280000,-59,-1214000
66,1516,"Franklin County, OH",2015.0,2016.0,591,21864000,563,12657000,28,9207000
67,1516,"Gilmer County, GA",2015.0,2016.0,162,4622000,167,6260000,-5,-1638000
68,1516,"Glynn County, GA",2015.0,2016.0,190,5725000,255,12977000,-65,-7252000
69,1516,"Gordon County, GA",2015.0,2016.0,139,2528000,170,4564000,-31,-2036000
70,1516,"Greene County, GA",2015.0,2016.0,37,1685000,59,6539000,-22,-4854000
71,1516,"Greenville County, SC",2015.0,2016.0,587,20962000,571,22677000,16,-1715000
72,1516,"Guilford County, NC",2015.0,2016.0,405,10528000,246,7780000,159,2748000
73,1516,"Habersham County, GA",2015.0,2016.0,52,1354000,74,1541000,-22,-187000
74,1516,"Hall County, GA",2015.0,2016.0,2786,81037000,4421,145393000,-1635,-64356000
75,1516,"Hamilton County, OH",2015.0,2016.0,459,17651000,292,8144000,167,9507000
76,1516,"Hamilton County, TN",2015.0,2016.0,476,20892000,581,21360000,-105,-468000
77,1516,"Haralson County, GA",2015.0,2016.0,150,3239000,218,3115000,-68,124000
78,1516,"Harris County, TX",2015.0,2016.0,1532,53524000,1544,83419000,-12,-29895000
79,1516,"Hartford County, CT",2015.0,2016.0,211,9389000,109,3940000,102,5449000
80,1516,"Hennepin County, MN",2015.0,2016.0,479,27282000,335,13060000,144,14222000
81,1516,"Henrico County, VA",2015.0,2016.0,202,9521000,89,3746000,113,5775000
82,1516,"Hillsborough County, FL",2015.0,2016.0,1342,47684000,1462,62331000,-120,-14647000
83,1516,"Honolulu County, HI",2015.0,2016.0,141,3636000,152,4392000,-11,-756000
84,1516,"Horry County, SC",2015.0,2016.0,105,1849000,86,2423000,19,-574000
85,1516,"Houston County, GA",2015.0,2016.0,758,16936000,519,9507000,239,7429000
86,1516,"Howard County, MD",2015.0,2016.0,100,3815000,69,2536000,31,1279000
87,1516,"Hudson County, NJ",2015.0,2016.0,342,15334000,218,10814000,124,4520000
88,1516,"Jackson County, GA",2015.0,2016.0,514,13991000,1279,38639000,-765,-24648000
89,1516,"Jackson County, MO",2015.0,2016.0,135,3215000,89,2610000,46,605000
90,1516,"Jasper County, GA",2015.0,2016.0,92,1637000,118,3175000,-26,-1538000
91,1516,"Jefferson County, AL",2015.0,2016.0,1119,38824000,702,23775000,417,15049000
92,1516,"Jefferson County, KY",2015.0,2016.0,356,12425000,292,13214000,64,-789000
93,1516,"Jefferson Parish, LA",2015.0,2016.0,230,6055000,160,3679000,70,2376000
94,1516,"Kent County, MI",2015.0,2016.0,43,1144000,43,1418000,0,-274000
95,1516,"King County, WA",2015.0,2016.0,534,23800000,984,56217000,-450,-32417000
96,1516,"Kings County, NY",2015.0,2016.0,1639,42080000,739,22057000,900,20023000
97,1516,"Knox County, TN",2015.0,2016.0,410,13119000,283,9670000,127,3449000
98,1516,"Lake County, IL",2015.0,2016.0,149,10736000,81,3234000,68,7502000
99,1516,"Lamar County, GA",2015.0,2016.0,77,1409000,90,2243000,-13,-834000
100,1516,"Lee County, AL",2015.0,2016.0,310,7652000,229,6312000,81,1340000
101,1516,"Lee County, FL",2015.0,2016.0,324,10091000,326,17659000,-2,-7568000
102,1516,"Leon County, FL",2015.0,2016.0,529,14841000,240,6590000,289,8251000
103,1516,"Lexington County, SC",2015.0,2016.0,67,1351000,42,1310000,25,41000
104,1516,"Liberty County, GA",2015.0,2016.0,75,1482000,80,1381000,-5,101000
105,1516,"Los Angeles County, CA",2015.0,2016.0,2378,116340000,1874,71185000,504,45155000
106,1516,"Loudoun County, VA",2015.0,2016.0,127,7102000,122,6550000,5,552000
107,1516,"Lowndes County, GA",2015.0,2016.0,381,5986000,225,4197000,156,1789000
108,1516,"Lumpkin County, GA",2015.0,2016.0,252,6132000,420,11043000,-168,-4911000
109,1516,"Madison County, AL",2015.0,2016.0,374,11289000,284,9360000,90,1929000
110,1516,"Madison County, GA",2015.0,2016.0,42,589000,55,1487000,-13,-898000
111,1516,"Manatee County, FL",2015.0,2016.0,146,5050000,243,14895000,-97,-9845000
112,1516,"Maricopa County, AZ",2015.0,2016.0,1055,35295000,1055,39939000,0,-4644000
113,1516,"Marion County, FL",2015.0,2016.0,35,593000,32,1365000,3,-772000
114,1516,"Marion County, IN",2015.0,2016.0,429,10455000,301,6654000,128,3801000
115,1516,"Mecklenburg County, NC",2015.0,2016.0,1465,56766000,1378,55190000,87,1576000
116,1516,"Meriwether County, GA",2015.0,2016.0,46,819000,51,1406000,-5,-587000
117,1516,"Miami, Dade County",2015.0,2016.0,2061,49657000,1140,46429000,921,3228000
118,1516,"Middlesex County, MA",2015.0,2016.0,504,26873000,357,21541000,147,5332000
119,1516,"Middlesex County, NJ",2015.0,2016.0,449,16191000,273,9475000,176,6716000
120,1516,"Milwaukee County, WI",2015.0,2016.0,480,10354000,201,6717000,279,3637000
121,1516,"Mobile County, AL",2015.0,2016.0,387,8795000,242,4346000,145,4449000
122,1516,"Monroe County, GA",2015.0,2016.0,53,1101000,127,2949000,-74,-1848000
123,1516,"Monroe County, NY",2015.0,2016.0,71,2721000,66,2339000,5,382000
124,1516,"Montgomery County, AL",2015.0,2016.0,459,10739000,247,4943000,212,5796000
125,1516,"Montgomery County, MD",2015.0,2016.0,495,23441000,521,19646000,-26,3795000
126,1516,"Montgomery County, OH",2015.0,2016.0,69,2823000,53,1019000,16,1804000
127,1516,"Montgomery County, PA",2015.0,2016.0,94,6070000,43,3052000,51,3018000
128,1516,"Morris County, NJ",2015.0,2016.0,86,9039000,45,2345000,41,6694000
129,1516,"Multnomah County, OR",2015.0,2016.0,70,4091000,151,7247000,-81,-3156000
130,1516,"Muscogee County, GA",2015.0,2016.0,1262,28159000,721,14403000,541,13756000
131,1516,"Nassau County, NY",2015.0,2016.0,330,8809000,77,2130000,253,6679000
132,1516,"New Castle County, DE",2015.0,2016.0,153,4928000,89,1971000,64,2957000
133,1516,"New Hanover County, NC",2015.0,2016.0,73,2412000,35,1152000,38,1260000
134,1516,"New Haven County, CT",2015.0,2016.0,104,3205000,30,2239000,74,966000
135,1516,"New York County, NY",2015.0,2016.0,870,76801000,799,64709000,71,12092000
136,1516,"Newton County, GA",2015.0,2016.0,3229,52162000,4067,66794000,-838,-14632000
137,1516,"Norfolk County, MA",2015.0,2016.0,108,7258000,80,3794000,28,3464000
138,1516,"Norfolk city, VA",2015.0,2016.0,110,2147000,68,2156000,42,-9000
139,1516,"Oakland County, MI",2015.0,2016.0,445,17601000,314,11398000,131,6203000
140,1516,"Oconee County, GA",2015.0,2016.0,105,4209000,212,10485000,-107,-6276000
141,1516,"Okaloosa County, FL",2015.0,2016.0,90,1555000,125,4630000,-35,-3075000
142,1516,"Onslow County, NC",2015.0,2016.0,50,1018000,38,812000,12,206000
143,1516,"Orange County, CA",2015.0,2016.0,560,27378000,495,27008000,65,370000
144,1516,"Orange County, FL",2015.0,2016.0,1488,38784000,1285,39610000,203,-826000
145,1516,"Orange County, NC",2015.0,2016.0,37,1486000,58,2468000,-21,-982000
146,1516,"Orleans Parish, LA",2015.0,2016.0,436,10933000,380,7177000,56,3756000
147,1516,"Osceola County, FL",2015.0,2016.0,148,2309000,146,3019000,2,-710000
148,1516,"Palm Beach County, FL",2015.0,2016.0,1092,36371000,916,46843000,176,-10472000
149,1516,"Pasco County, FL",2015.0,2016.0,189,5918000,191,4940000,-2,978000
150,1516,"Paulding County, GA",2015.0,2016.0,4519,107703000,6882,152519000,-2363,-44816000
151,1516,"Philadelphia County, PA",2015.0,2016.0,616,17846000,386,12585000,230,5261000
152,1516,"Pickens County, GA",2015.0,2016.0,607,16873000,987,33055000,-380,-16182000
153,1516,"Pierce County, WA",2015.0,2016.0,90,2531000,85,2088000,5,443000
154,1516,"Pike County, GA",2015.0,2016.0,46,765000,115,2402000,-69,-1637000
155,1516,"Pinellas County, FL",2015.0,2016.0,685,25568000,790,40508000,-105,-14940000
156,1516,"Polk County, FL",2015.0,2016.0,246,5409000,294,6325000,-48,-916000
157,1516,"Polk County, GA",2015.0,2016.0,82,1454000,101,1955000,-19,-501000
158,1516,"Prince George's County, MD",2015.0,2016.0,649,15315000,398,8009000,251,7306000
159,1516,"Prince William County, VA",2015.0,2016.0,67,2875000,57,1676000,10,1199000
160,1516,"Pulaski County, AR",2015.0,2016.0,88,2957000,109,3133000,-21,-176000
161,1516,"Queens County, NY",2015.0,2016.0,1199,28181000,438,9195000,761,18986000
162,1516,"Ramsey County, MN",2015.0,2016.0,51,1475000,72,1500000,-21,-25000
163,1516,"Richland County, SC",2015.0,2016.0,614,16312000,307,8154000,307,8158000
164,1516,"Richmond County, GA",2015.0,2016.0,802,18764000,557,9953000,245,8811000
165,1516,"Richmond city, VA",2015.0,2016.0,146,5195000,93,3898000,53,1297000
166,1516,"Riverside County, CA",2015.0,2016.0,228,5417000,241,6572000,-13,-1155000
167,1516,"Rutherford County, TN",2015.0,2016.0,105,3152000,90,3205000,15,-53000
168,1516,"Sacramento County, CA",2015.0,2016.0,219,6744000,235,5260000,-16,1484000
169,1516,"Salt Lake County, UT",2015.0,2016.0,69,3140000,57,3240000,12,-100000
170,1516,"San Bernardino County, CA",2015.0,2016.0,271,7272000,196,3889000,75,3383000
171,1516,"San Diego County, CA",2015.0,2016.0,684,22190000,664,28446000,20,-6256000
172,1516,"San Francisco County, CA",2015.0,2016.0,198,16785000,304,30431000,-106,-13646000
173,1516,"San Mateo County, CA",2015.0,2016.0,122,8038000,119,9230000,3,-1192000
174,1516,"Santa Clara County, CA",2015.0,2016.0,406,22669000,542,45325000,-136,-22656000
175,1516,"Sarasota County, FL",2015.0,2016.0,103,3545000,146,13857000,-43,-10312000
176,1516,"Seminole County, FL",2015.0,2016.0,359,13149000,325,11052000,34,2097000
177,1516,"Shelby County, AL",2015.0,2016.0,281,15601000,162,7270000,119,8331000
178,1516,"Shelby County, TN",2015.0,2016.0,1065,28875000,559,16683000,506,12192000
179,1516,"Spalding County, GA",2015.0,2016.0,1309,20144000,1733,29249000,-424,-9105000
180,1516,"Spartanburg County, SC",2015.0,2016.0,99,2345000,76,2287000,23,58000
181,1516,"St. Johns County, FL",2015.0,2016.0,172,11968000,225,21696000,-53,-9728000
182,1516,"St. Louis County, MO",2015.0,2016.0,495,20352000,256,8867000,239,11485000
183,1516,"St. Louis city, MO",2015.0,2016.0,61,2678000,43,1645000,18,1033000
184,1516,"St. Lucie County, FL",2015.0,2016.0,113,2281000,155,4395000,-42,-2114000
185,1516,"Suffolk County, MA",2015.0,2016.0,313,13648000,226,12248000,87,1400000
186,1516,"Suffolk County, NY",2015.0,2016.0,528,14634000,226,4468000,302,10166000
187,1516,"Summit County, OH",2015.0,2016.0,45,1063000,44,683000,1,380000
188,1516,"Tarrant County, TX",2015.0,2016.0,583,21962000,720,25309000,-137,-3347000
189,1516,"Travis County, TX",2015.0,2016.0,3116,53618000,1132,30896000,1984,22722000
190,1516,"Troup County, GA",2015.0,2016.0,220,5832000,131,2363000,89,3469000
191,1516,"Upson County, GA",2015.0,2016.0,43,618000,55,1037000,-12,-419000
192,1516,"Virginia Beach city, VA",2015.0,2016.0,296,7231000,186,3680000,110,3551000
193,1516,"Volusia County, FL",2015.0,2016.0,268,6287000,288,12315000,-20,-6028000
194,1516,"Wake County, NC",2015.0,2016.0,911,37374000,778,32275000,133,5099000
195,1516,"Walton County, FL",2015.0,2016.0,31,4000000,77,6944000,-46,-2944000
196,1516,"Walton County, GA",2015.0,2016.0,1611,35527000,2732,60729000,-1121,-25202000
197,1516,"Washtenaw County, MI",2015.0,2016.0,101,4615000,81,3227000,20,1388000
198,1516,"Wayne County, MI",2015.0,2016.0,752,12849000,487,7480000,265,5369000
199,1516,"Westchester County, NY",2015.0,2016.0,274,10013000,106,9935000,168,78000
200,1516,"White County, GA",2015.0,2016.0,35,837000,73,2855000,-38,-2018000
201,1516,"Whitfield County, GA",2015.0,2016.0,116,3421000,116,2169000,0,1252000
202,1516,"Williamson County, TN",2015.0,2016.0,122,6926000,198,12099000,-76,-5173000
203,1516,"Williamson County, TX",2015.0,2016.0,67,2981000,44,1776000,23,1205000
204,1617,"Aiken County, SC",2016.0,2017.0,138,3725000,125,3775000,13,-50000
205,1617,"Alachua County, FL",2016.0,2017.0,418,13556000,244,7540000,174,6016000
206,1617,"Alameda County, CA",2016.0,2017.0,654,30297000,585,28273000,69,2024000
207,1617,"Alexandria city, VA",2016.0,2017.0,230,15877000,161,9848000,69,6029000
208,1617,"Allegheny County, PA",2016.0,2017.0,576,21108000,407,13060000,169,8048000
209,1617,"Anderson County, SC",2016.0,2017.0,46,1134000,93,4583000,-47,-3449000
210,1617,"Anne Arundel County, MD",2016.0,2017.0,268,9174000,246,8823000,22,351000
211,1617,"Arapahoe County, CO",2016.0,2017.0,327,10869000,324,14502000,3,-3633000
212,1617,"Arlington County, VA",2016.0,2017.0,295,20106000,200,11772000,95,8334000
213,1617,"Baldwin County, AL",2016.0,2017.0,114,4020000,181,9385000,-67,-5365000
214,1617,"Baldwin County, GA",2016.0,2017.0,61,1758000,42,1293000,19,465000
215,1617,"Baltimore County, MD",2016.0,2017.0,456,16480000,307,8794000,149,7686000
216,1617,"Baltimore city, MD",2016.0,2017.0,344,12280000,254,9539000,90,2741000
217,1617,"Barrow County, GA",2016.0,2017.0,1824,41957000,3781,91120000,-1957,-49163000
218,1617,"Bartow County, GA",2016.0,2017.0,1877,43836000,3171,95224000,-1294,-51388000
219,1617,"Bay County, FL",2016.0,2017.0,190,5175000,239,10733000,-49,-5558000
220,1617,"Beaufort County, SC",2016.0,2017.0,279,10146000,542,40605000,-263,-30459000
221,1617,"Bell County, TX",2016.0,2017.0,60,1537000,44,999000,16,538000
222,1617,"Bergen County, NJ",2016.0,2017.0,491,22640000,214,8210000,277,14430000
223,1617,"Berkeley County, SC",2016.0,2017.0,128,5085000,176,8430000,-48,-3345000
224,1617,"Bernalillo County, NM",2016.0,2017.0,42,1741000,61,2634000,-19,-893000
225,1617,"Bexar County, TX",2016.0,2017.0,533,22229000,477,13749000,56,8480000
226,1617,"Bibb County, GA",2016.0,2017.0,1355,32930000,953,20478000,402,12452000
227,1617,"Boulder County, CO",2016.0,2017.0,65,2705000,162,9438000,-97,-6733000
228,1617,"Brevard County, FL",2016.0,2017.0,356,10093000,563,24408000,-207,-14315000
229,1617,"Bronx County, NY",2016.0,2017.0,957,18040000,297,4532000,660,13508000
230,1617,"Broward County, FL",2016.0,2017.0,3762,101448000,1902,73702000,1860,27746000
231,1617,"Bulloch County, GA",2016.0,2017.0,352,6975000,190,4944000,162,2031000
232,1617,"Buncombe County, NC",2016.0,2017.0,204,5938000,370,16341000,-166,-10403000
233,1617,"Burlington County, NJ",2016.0,2017.0,54,2950000,35,1832000,19,1118000
234,1617,"Butts County, GA",2016.0,2017.0,477,9298000,849,19818000,-372,-10520000
235,1617,"Calhoun County, AL",2016.0,2017.0,59,1738000,34,1210000,25,528000
236,1617,"Carroll County, GA",2016.0,2017.0,2281,52306000,2849,64662000,-568,-12356000
237,1617,"Catoosa County, GA",2016.0,2017.0,38,875000,33,1052000,5,-177000
238,1617,"Charleston County, SC",2016.0,2017.0,668,23134000,745,39943000,-77,-16809000
239,1617,"Chatham County, GA",2016.0,2017.0,2028,54476000,1501,47218000,527,7258000
240,1617,"Chesterfield County, VA",2016.0,2017.0,199,10098000,141,5852000,58,4246000
241,1617,"Clark County, NV",2016.0,2017.0,760,19690000,983,26664000,-223,-6974000
242,1617,"Clarke County, GA",2016.0,2017.0,1731,44822000,1584,44065000,147,757000
243,1617,"Clay County, FL",2016.0,2017.0,56,1194000,74,1719000,-18,-525000
244,1617,"Collier County, FL",2016.0,2017.0,119,5726000,166,15229000,-47,-9503000
245,1617,"Collin County, TX",2016.0,2017.0,619,35076000,878,40856000,-259,-5780000
246,1617,"Columbia County, GA",2016.0,2017.0,566,19347000,516,15975000,50,3372000
247,1617,"Contra Costa County, CA",2016.0,2017.0,392,22770000,254,12087000,138,10683000
248,1617,"Cook County, IL",2016.0,2017.0,3699,179258000,2161,93351000,1538,85907000
249,1617,"Coweta County, GA",2016.0,2017.0,3644,104943000,5415,184134000,-1771,-79191000
250,1617,"Cumberland County, NC",2016.0,2017.0,420,8243000,307,5569000,113,2674000
251,1617,"Cuyahoga County, OH",2016.0,2017.0,583,18745000,436,12136000,147,6609000
252,1617,"Dallas County, TX",2016.0,2017.0,1313,60576000,1505,72026000,-192,-11450000
253,1617,"Dane County, WI",2016.0,2017.0,134,5736000,105,3929000,29,1807000
254,1617,"Davidson County, TN",2016.0,2017.0,988,37120000,1073,46922000,-85,-9802000
255,1617,"Dawson County, GA",2016.0,2017.0,894,22963000,1626,51595000,-732,-28632000
256,1617,"Delaware County, PA",2016.0,2017.0,96,4617000,127,4367000,-31,250000
257,1617,"Denton County, TX",2016.0,2017.0,354,18732000,474,24097000,-120,-5365000
258,1617,"Denver County, CO",2016.0,2017.0,357,16795000,595,35769000,-238,-18974000
259,1617,"District of Columbia, DC",2016.0,2017.0,692,39834000,632,37188000,60,2646000
260,1617,"Dorchester County, SC",2016.0,2017.0,59,1091000,57,1580000,2,-489000
261,1617,"Dougherty County, GA",2016.0,2017.0,801,13414000,379,5928000,422,7486000
262,1617,"DuPage County, IL",2016.0,2017.0,562,29800000,299,15562000,263,14238000
263,1617,"Durham County, NC",2016.0,2017.0,460,18875000,322,12961000,138,5914000
264,1617,"Duval County, FL",2016.0,2017.0,1787,60067000,1735,59584000,52,483000
265,1617,"East Baton Rouge Parish, LA",2016.0,2017.0,306,9006000,190,5095000,116,3911000
266,1617,"El Paso County, CO",2016.0,2017.0,305,7208000,297,9244000,8,-2036000
267,1617,"El Paso County, TX",2016.0,2017.0,92,1594000,49,809000,43,785000
268,1617,"Erie County, NY",2016.0,2017.0,381,9264000,225,5019000,156,4245000
269,1617,"Escambia County, FL",2016.0,2017.0,356,10501000,396,15211000,-40,-4710000
270,1617,"Essex County, NJ",2016.0,2017.0,674,20215000,307,9359000,367,10856000
271,1617,"Fairfax County, VA",2016.0,2017.0,851,40448000,685,33847000,166,6601000
272,1617,"Fairfield County, CT",2016.0,2017.0,548,39114000,219,17230000,329,21884000
273,1617,"Fannin County, GA",2016.0,2017.0,41,1287000,79,3689000,-38,-2402000
274,1617,"Floyd County, GA",2016.0,2017.0,430,14720000,559,15569000,-129,-849000
275,1617,"Fort Bend County, TX",2016.0,2017.0,318,15764000,276,9597000,42,6167000
276,1617,"Franklin County, OH",2016.0,2017.0,779,28077000,794,32301000,-15,-4224000
277,1617,"Gilmer County, GA",2016.0,2017.0,116,2376000,244,7325000,-128,-4949000
278,1617,"Glynn County, GA",2016.0,2017.0,297,8621000,445,24063000,-148,-15442000
279,1617,"Gordon County, GA",2016.0,2017.0,165,3619000,220,6278000,-55,-2659000
280,1617,"Greene County, GA",2016.0,2017.0,28,1238000,113,6825000,-85,-5587000
281,1617,"Greenville County, SC",2016.0,2017.0,726,27433000,799,33565000,-73,-6132000
282,1617,"Guilford County, NC",2016.0,2017.0,501,17397000,334,11995000,167,5402000
283,1617,"Habersham County, GA",2016.0,2017.0,58,1148000,160,5930000,-102,-4782000
284,1617,"Hall County, GA",2016.0,2017.0,3575,117883000,6078,229477000,-2503,-111594000
285,1617,"Hamilton County, IN",2016.0,2017.0,75,3600000,68,3753000,7,-153000
286,1617,"Hamilton County, OH",2016.0,2017.0,508,20625000,503,15923000,5,4702000
287,1617,"Hamilton County, TN",2016.0,2017.0,767,27210000,812,33517000,-45,-6307000
288,1617,"Haralson County, GA",2016.0,2017.0,86,1426000,223,3969000,-137,-2543000
289,1617,"Harris County, TX",2016.0,2017.0,2148,83044000,1737,61240000,411,21804000
290,1617,"Harrison County, MS",2016.0,2017.0,38,993000,38,912000,0,81000
291,1617,"Hart County, GA",2016.0,2017.0,43,1260000,115,4575000,-72,-3315000
292,1617,"Hartford County, CT",2016.0,2017.0,445,17569000,232,9605000,213,7964000
293,1617,"Hennepin County, MN",2016.0,2017.0,545,25819000,493,27300000,52,-1481000
294,1617,"Henrico County, VA",2016.0,2017.0,251,10901000,192,8522000,59,2379000
295,1617,"Hillsborough County, FL",2016.0,2017.0,2007,63785000,1944,76170000,63,-12385000
296,1617,"Hinds County, MS",2016.0,2017.0,84,1283000,50,812000,34,471000
297,1617,"Honolulu County, HI",2016.0,2017.0,344,9459000,202,6814000,142,2645000
298,1617,"Horry County, SC",2016.0,2017.0,163,4278000,187,8015000,-24,-3737000
299,1617,"Houston County, GA",2016.0,2017.0,866,21449000,762,15865000,104,5584000
300,1617,"Howard County, MD",2016.0,2017.0,146,6697000,113,3386000,33,3311000
301,1617,"Hudson County, NJ",2016.0,2017.0,362,28930000,257,15729000,105,13201000
302,1617,"Jackson County, GA",2016.0,2017.0,758,19515000,2386,73243000,-1628,-53728000
303,1617,"Jackson County, MO",2016.0,2017.0,294,9467000,210,4775000,84,4692000
304,1617,"Jasper County, GA",2016.0,2017.0,49,1464000,127,3554000,-78,-2090000
305,1617,"Jefferson County, AL",2016.0,2017.0,1578,53221000,1174,46289000,404,6932000
306,1617,"Jefferson County, KY",2016.0,2017.0,444,16561000,496,17317000,-52,-756000
307,1617,"Jefferson Parish, LA",2016.0,2017.0,345,8587000,257,5948000,88,2639000
308,1617,"Johnson County, KS",2016.0,2017.0,177,8579000,139,8516000,38,63000
309,1617,"Kent County, MI",2016.0,2017.0,262,5539000,200,5383000,62,156000
310,1617,"King County, WA",2016.0,2017.0,859,45978000,1321,82374000,-462,-36396000
311,1617,"Kings County, NY",2016.0,2017.0,2181,60227000,942,28536000,1239,31691000
312,1617,"Knox County, TN",2016.0,2017.0,570,22259000,519,19851000,51,2408000
313,1617,"Lake County, FL",2016.0,2017.0,148,3768000,196,7793000,-48,-4025000
314,1617,"Lake County, IL",2016.0,2017.0,135,7518000,63,4625000,72,2893000
315,1617,"Lamar County, GA",2016.0,2017.0,78,1769000,196,4851000,-118,-3082000
316,1617,"Lee County, AL",2016.0,2017.0,425,10347000,306,16888000,119,-6541000
317,1617,"Lee County, FL",2016.0,2017.0,505,15881000,498,22997000,7,-7116000
318,1617,"Leon County, FL",2016.0,2017.0,624,19196000,337,11280000,287,7916000
319,1617,"Lexington County, SC",2016.0,2017.0,206,6788000,163,5935000,43,853000
320,1617,"Liberty County, GA",2016.0,2017.0,199,3960000,133,1826000,66,2134000
321,1617,"Los Angeles County, CA",2016.0,2017.0,3241,124339000,2323,105455000,918,18884000
322,1617,"Loudoun County, VA",2016.0,2017.0,260,15466000,342,15416000,-82,50000
323,1617,"Lowndes County, GA",2016.0,2017.0,417,10516000,252,5481000,165,5035000
324,1617,"Lumpkin County, GA",2016.0,2017.0,325,8570000,713,22955000,-388,-14385000
325,1617,"Macomb County, MI",2016.0,2017.0,61,1772000,57,1228000,4,544000
326,1617,"Madison County, AL",2016.0,2017.0,459,14631000,366,12440000,93,2191000
327,1617,"Manatee County, FL",2016.0,2017.0,241,7216000,410,24486000,-169,-17270000
328,1617,"Maricopa County, AZ",2016.0,2017.0,1580,72345000,1548,61853000,32,10492000
329,1617,"Marion County, FL",2016.0,2017.0,148,3544000,164,3859000,-16,-315000
330,1617,"Marion County, IN",2016.0,2017.0,592,14134000,485,9736000,107,4398000
331,1617,"Mecklenburg County, NC",2016.0,2017.0,2131,90729000,1907,87141000,224,3588000
332,1617,"Mercer County, NJ",2016.0,2017.0,88,3578000,57,1960000,31,1618000
333,1617,"Meriwether County, GA",2016.0,2017.0,113,1909000,113,2823000,0,-914000
334,1617,"Miami, Dade County",2016.0,2017.0,3257,104692000,1259,40544000,1998,64148000
335,1617,"Middlesex County, MA",2016.0,2017.0,610,28784000,491,24983000,119,3801000
336,1617,"Middlesex County, NJ",2016.0,2017.0,637,22397000,288,10122000,349,12275000
337,1617,"Milwaukee County, WI",2016.0,2017.0,442,11314000,274,6770000,168,4544000
338,1617,"Mobile County, AL",2016.0,2017.0,522,11870000,387,9141000,135,2729000
339,1617,"Monroe County, GA",2016.0,2017.0,88,1546000,212,4678000,-124,-3132000
340,1617,"Monroe County, NY",2016.0,2017.0,221,6570000,89,2761000,132,3809000
341,1617,"Montgomery County, AL",2016.0,2017.0,627,16707000,298,5882000,329,10825000
342,1617,"Montgomery County, MD",2016.0,2017.0,764,32708000,584,24876000,180,7832000
343,1617,"Montgomery County, OH",2016.0,2017.0,274,6740000,170,4731000,104,2009000
344,1617,"Montgomery County, PA",2016.0,2017.0,301,17218000,185,9184000,116,8034000
345,1617,"Montgomery County, TN",2016.0,2017.0,101,1535000,109,1472000,-8,63000
346,1617,"Montgomery County, TX",2016.0,2017.0,54,2403000,61,2825000,-7,-422000
347,1617,"Morris County, NJ",2016.0,2017.0,101,6598000,55,6270000,46,328000
348,1617,"Multnomah County, OR",2016.0,2017.0,145,8217000,184,8890000,-39,-673000
349,1617,"Muscogee County, GA",2016.0,2017.0,1442,32967000,963,21914000,479,11053000
350,1617,"Nassau County, NY",2016.0,2017.0,692,20761000,258,7221000,434,13540000
351,1617,"New Castle County, DE",2016.0,2017.0,246,7084000,154,4960000,92,2124000
352,1617,"New Hanover County, NC",2016.0,2017.0,92,3942000,112,7496000,-20,-3554000
353,1617,"New Haven County, CT",2016.0,2017.0,246,8088000,174,6403000,72,1685000
354,1617,"New York County, NY",2016.0,2017.0,1165,99644000,976,79935000,189,19709000
355,1617,"Newport News city, VA",2016.0,2017.0,66,1043000,43,662000,23,381000
356,1617,"Newton County, GA",2016.0,2017.0,4493,77832000,5652,97590000,-1159,-19758000
357,1617,"Norfolk County, MA",2016.0,2017.0,227,13435000,186,10288000,41,3147000
358,1617,"Norfolk city, VA",2016.0,2017.0,194,4443000,125,2444000,69,1999000
359,1617,"Oakland County, MI",2016.0,2017.0,748,31339000,473,26529000,275,4810000
360,1617,"Oconee County, GA",2016.0,2017.0,153,9525000,397,17875000,-244,-8350000
361,1617,"Okaloosa County, FL",2016.0,2017.0,206,5232000,189,7151000,17,-1919000
362,1617,"Oklahoma County, OK",2016.0,2017.0,51,1187000,34,938000,17,249000
363,1617,"Onondaga County, NY",2016.0,2017.0,83,2021000,43,1729000,40,292000
364,1617,"Onslow County, NC",2016.0,2017.0,78,1374000,52,708000,26,666000
365,1617,"Orange County, CA",2016.0,2017.0,887,50331000,762,40272000,125,10059000
366,1617,"Orange County, FL",2016.0,2017.0,2179,57587000,1826,62943000,353,-5356000
367,1617,"Orange County, NC",2016.0,2017.0,76,3890000,38,2046000,38,1844000
368,1617,"Orleans Parish, LA",2016.0,2017.0,462,11231000,376,12126000,86,-895000
369,1617,"Osceola County, FL",2016.0,2017.0,247,5127000,227,5833000,20,-706000
370,1617,"Palm Beach County, FL",2016.0,2017.0,1863,66599000,1278,61428000,585,5171000
371,1617,"Pasco County, FL",2016.0,2017.0,221,6169000,317,12495000,-96,-6326000
372,1617,"Paulding County, GA",2016.0,2017.0,6542,176000000,10759,251185000,-4217,-75185000
373,1617,"Philadelphia County, PA",2016.0,2017.0,889,27153000,545,21631000,344,5522000
374,1617,"Pickens County, GA",2016.0,2017.0,883,26074000,1690,62556000,-807,-36482000
375,1617,"Pierce County, WA",2016.0,2017.0,244,5921000,238,6423000,6,-502000
376,1617,"Pike County, GA",2016.0,2017.0,102,2761000,307,9322000,-205,-6561000
377,1617,"Pima County, AZ",2016.0,2017.0,158,6841000,194,7413000,-36,-572000
378,1617,"Pinellas County, FL",2016.0,2017.0,918,34854000,1047,52433000,-129,-17579000
379,1617,"Polk County, FL",2016.0,2017.0,401,8779000,406,9293000,-5,-514000
380,1617,"Polk County, GA",2016.0,2017.0,111,1953000,140,3044000,-29,-1091000
381,1617,"Prince George's County, MD",2016.0,2017.0,832,24952000,521,11738000,311,13214000
382,1617,"Prince William County, VA",2016.0,2017.0,325,11749000,221,5844000,104,5905000
383,1617,"Providence County, RI",2016.0,2017.0,58,1856000,43,1924000,15,-68000
384,1617,"Pulaski County, AR",2016.0,2017.0,150,5029000,114,3471000,36,1558000
385,1617,"Putnam County, GA",2016.0,2017.0,36,2072000,43,3218000,-7,-1146000
386,1617,"Queens County, NY",2016.0,2017.0,1656,42217000,555,14235000,1101,27982000
387,1617,"Ramsey County, MN",2016.0,2017.0,56,1229000,82,1633000,-26,-404000
388,1617,"Richland County, SC",2016.0,2017.0,777,23191000,526,16094000,251,7097000
389,1617,"Richmond County, GA",2016.0,2017.0,1066,22054000,674,14010000,392,8044000
390,1617,"Richmond city, VA",2016.0,2017.0,163,5605000,113,4671000,50,934000
391,1617,"Riverside County, CA",2016.0,2017.0,361,10041000,309,9232000,52,809000
392,1617,"Rutherford County, TN",2016.0,2017.0,229,6706000,175,5357000,54,1349000
393,1617,"Sacramento County, CA",2016.0,2017.0,298,8098000,261,7374000,37,724000
394,1617,"Salt Lake County, UT",2016.0,2017.0,254,7766000,313,11195000,-59,-3429000
395,1617,"San Bernardino County, CA",2016.0,2017.0,311,6393000,227,4510000,84,1883000
396,1617,"San Diego County, CA",2016.0,2017.0,1075,40616000,856,33517000,219,7099000
397,1617,"San Francisco County, CA",2016.0,2017.0,300,27712000,326,32712000,-26,-5000000
398,1617,"San Mateo County, CA",2016.0,2017.0,101,16145000,77,6912000,24,9233000
399,1617,"Santa Clara County, CA",2016.0,2017.0,676,41956000,710,51082000,-34,-9126000
400,1617,"Sarasota County, FL",2016.0,2017.0,225,10800000,333,20106000,-108,-9306000
401,1617,"Seminole County, FL",2016.0,2017.0,528,16589000,476,15136000,52,1453000
402,1617,"Shelby County, AL",2016.0,2017.0,320,13061000,325,13917000,-5,-856000
403,1617,"Shelby County, TN",2016.0,2017.0,1204,38178000,730,22674000,474,15504000
404,1617,"Snohomish County, WA",2016.0,2017.0,132,4252000,107,4362000,25,-110000
405,1617,"Somerset County, NJ",2016.0,2017.0,98,12270000,41,3916000,57,8354000
406,1617,"Spalding County, GA",2016.0,2017.0,1697,28699000,2320,45525000,-623,-16826000
407,1617,"Spartanburg County, SC",2016.0,2017.0,205,5729000,209,6444000,-4,-715000
408,1617,"St. Johns County, FL",2016.0,2017.0,211,11739000,368,21062000,-157,-9323000
409,1617,"St. Louis County, MO",2016.0,2017.0,575,20785000,360,15657000,215,5128000
410,1617,"St. Louis city, MO",2016.0,2017.0,108,3792000,89,3224000,19,568000
411,1617,"St. Lucie County, FL",2016.0,2017.0,268,4641000,204,7665000,64,-3024000
412,1617,"St. Tammany Parish, LA",2016.0,2017.0,39,1242000,48,1982000,-9,-740000
413,1617,"Stephens County, GA",2016.0,2017.0,35,686000,79,2130000,-44,-1444000
414,1617,"Suffolk County, MA",2016.0,2017.0,411,26741000,300,14186000,111,12555000
415,1617,"Suffolk County, NY",2016.0,2017.0,711,22289000,277,8696000,434,13593000
416,1617,"Summit County, OH",2016.0,2017.0,65,2952000,30,927000,35,2025000
417,1617,"Tarrant County, TX",2016.0,2017.0,813,39233000,954,38961000,-141,272000
418,1617,"Travis County, TX",2016.0,2017.0,1206,38122000,862,37828000,344,294000
419,1617,"Troup County, GA",2016.0,2017.0,334,5421000,399,7724000,-65,-2303000
420,1617,"Tulsa County, OK",2016.0,2017.0,54,2180000,41,1641000,13,539000
421,1617,"Tuscaloosa County, AL",2016.0,2017.0,65,1766000,52,1911000,13,-145000
422,1617,"Union County, NJ",2016.0,2017.0,105,2606000,51,972000,54,1634000
423,1617,"Ventura County, CA",2016.0,2017.0,70,4256000,61,3352000,9,904000
424,1617,"Virginia Beach city, VA",2016.0,2017.0,383,14006000,270,7814000,113,6192000
425,1617,"Volusia County, FL",2016.0,2017.0,338,8509000,392,13990000,-54,-5481000
426,1617,"Wake County, NC",2016.0,2017.0,1319,57404000,1180,54361000,139,3043000
427,1617,"Walton County, FL",2016.0,2017.0,38,3818000,124,40405000,-86,-36587000
428,1617,"Walton County, GA",2016.0,2017.0,2323,52111000,4276,113161000,-1953,-61050000
429,1617,"Washington County, OR",2016.0,2017.0,54,2109000,61,3170000,-7,-1061000
430,1617,"Washtenaw County, MI",2016.0,2017.0,145,5789000,98,4663000,47,1126000
431,1617,"Wayne County, MI",2016.0,2017.0,873,21110000,595,10711000,278,10399000
432,1617,"Westchester County, NY",2016.0,2017.0,438,24638000,188,7784000,250,16854000
433,1617,"White County, GA",2016.0,2017.0,81,2322000,273,11250000,-192,-8928000
434,1617,"Whitfield County, GA",2016.0,2017.0,142,4807000,98,3196000,44,1611000
435,1617,"Williamson County, TN",2016.0,2017.0,181,11290000,273,17269000,-92,-5979000
436,1617,"Williamson County, TX",2016.0,2017.0,111,5240000,153,5485000,-42,-245000
437,1617,"Worcester County, MA",2016.0,2017.0,61,2882000,36,1782000,25,1100000
438,1617,"York County, SC",2016.0,2017.0,149,6059000,225,10252000,-76,-4193000
439,1718,"Alachua County, FL",2017.0,2018.0,330,9715000,134,5038000,196,4677000
440,1718,"Alameda County, CA",2017.0,2018.0,447,22765000,383,18556000,64,4209000
441,1718,"Alexandria city, VA",2017.0,2018.0,65,5084000,73,8500000,-8,-3416000
442,1718,"Allegheny County, PA",2017.0,2018.0,435,15918000,385,16954000,50,-1036000
443,1718,"Anne Arundel County, MD",2017.0,2018.0,207,7769000,153,5761000,54,2008000
444,1718,"Arapahoe County, CO",2017.0,2018.0,215,7600000,268,11729000,-53,-4129000
445,1718,"Arlington County, VA",2017.0,2018.0,166,11877000,137,8383000,29,3494000
446,1718,"Baldwin County, AL",2017.0,2018.0,68,2639000,87,4153000,-19,-1514000
447,1718,"Baldwin County, GA",2017.0,2018.0,79,2392000,86,2295000,-7,97000
448,1718,"Baltimore County, MD",2017.0,2018.0,344,11838000,226,4981000,118,6857000
449,1718,"Baltimore city, MD",2017.0,2018.0,259,7725000,195,5914000,64,1811000
450,1718,"Barrow County, GA",2017.0,2018.0,1481,34276000,3369,78416000,-1888,-44140000
451,1718,"Bartow County, GA",2017.0,2018.0,1490,35410000,2577,61354000,-1087,-25944000
452,1718,"Bay County, FL",2017.0,2018.0,256,10058000,275,10239000,-19,-181000
453,1718,"Beaufort County, SC",2017.0,2018.0,236,10622000,334,29587000,-98,-18965000
454,1718,"Bell County, TX",2017.0,2018.0,115,2128000,82,1410000,33,718000
455,1718,"Bergen County, NJ",2017.0,2018.0,469,17966000,183,7851000,286,10115000
456,1718,"Berkeley County, SC",2017.0,2018.0,157,4545000,154,5525000,3,-980000
457,1718,"Bernalillo County, NM",2017.0,2018.0,40,1042000,41,1547000,-1,-505000
458,1718,"Bexar County, TX",2017.0,2018.0,422,11852000,391,10590000,31,1262000
459,1718,"Bibb County, GA",2017.0,2018.0,1056,25947000,843,18289000,213,7658000
460,1718,"Boulder County, CO",2017.0,2018.0,26,1300000,40,2966000,-14,-1666000
461,1718,"Brevard County, FL",2017.0,2018.0,324,8784000,373,17228000,-49,-8444000
462,1718,"Bronx County, NY",2017.0,2018.0,794,15961000,342,5305000,452,10656000
463,1718,"Broward County, FL",2017.0,2018.0,2976,83675000,1603,63561000,1373,20114000
464,1718,"Bulloch County, GA",2017.0,2018.0,108,2444000,75,1657000,33,787000
465,1718,"Buncombe County, NC",2017.0,2018.0,153,8222000,225,14326000,-72,-6104000
466,1718,"Butts County, GA",2017.0,2018.0,352,5737000,642,15961000,-290,-10224000
467,1718,"Carroll County, GA",2017.0,2018.0,1863,47421000,2277,51657000,-414,-4236000
468,1718,"Charleston County, SC",2017.0,2018.0,467,15997000,540,28412000,-73,-12415000
469,1718,"Chatham County, GA",2017.0,2018.0,1447,40588000,1120,32192000,327,8396000
470,1718,"Chester County, PA",2017.0,2018.0,65,3204000,43,3070000,22,134000
471,1718,"Clark County, NV",2017.0,2018.0,675,16454000,711,23190000,-36,-6736000
472,1718,"Clarke County, GA",2017.0,2018.0,1230,35632000,1100,31992000,130,3640000
473,1718,"Clay County, FL",2017.0,2018.0,59,1196000,51,1296000,8,-100000
474,1718,"Collier County, FL",2017.0,2018.0,57,4231000,62,10023000,-5,-5792000
475,1718,"Collin County, TX",2017.0,2018.0,425,17712000,554,27276000,-129,-9564000
476,1718,"Columbia County, GA",2017.0,2018.0,435,16533000,350,11506000,85,5027000
477,1718,"Contra Costa County, CA",2017.0,2018.0,216,14520000,179,9682000,37,4838000
478,1718,"Cook County, IL",2017.0,2018.0,2410,92988000,1508,62494000,902,30494000
479,1718,"Coweta County, GA",2017.0,2018.0,2867,85027000,3880,129653000,-1013,-44626000
480,1718,"Cumberland County, NC",2017.0,2018.0,213,4527000,223,3612000,-10,915000
481,1718,"Cuyahoga County, OH",2017.0,2018.0,483,15781000,398,11290000,85,4491000
482,1718,"Dallas County, TX",2017.0,2018.0,1046,45060000,1120,57974000,-74,-12914000
483,1718,"Dane County, WI",2017.0,2018.0,99,4116000,64,2775000,35,1341000
484,1718,"Davidson County, TN",2017.0,2018.0,857,38154000,775,40404000,82,-2250000
485,1718,"Dawson County, GA",2017.0,2018.0,600,16432000,1015,39686000,-415,-23254000
486,1718,"Delaware County, PA",2017.0,2018.0,93,2903000,98,2185000,-5,718000
487,1718,"Denton County, TX",2017.0,2018.0,261,11760000,373,16200000,-112,-4440000
488,1718,"Denver County, CO",2017.0,2018.0,222,13280000,370,24469000,-148,-11189000
489,1718,"District of Columbia, DC",2017.0,2018.0,503,36544000,489,25867000,14,10677000
490,1718,"Dorchester County, SC",2017.0,2018.0,28,888000,38,1337000,-10,-449000
491,1718,"Dougherty County, GA",2017.0,2018.0,493,7953000,335,5131000,158,2822000
492,1718,"DuPage County, IL",2017.0,2018.0,317,20132000,205,10006000,112,10126000
493,1718,"Durham County, NC",2017.0,2018.0,207,9698000,243,11344000,-36,-1646000
494,1718,"Duval County, FL",2017.0,2018.0,1302,60267000,1208,37933000,94,22334000
495,1718,"East Baton Rouge Parish, LA",2017.0,2018.0,71,1282000,34,706000,37,576000
496,1718,"El Paso County, CO",2017.0,2018.0,209,5013000,246,6227000,-37,-1214000
497,1718,"Erie County, NY",2017.0,2018.0,208,5597000,181,4462000,27,1135000
498,1718,"Escambia County, FL",2017.0,2018.0,310,8711000,246,9784000,64,-1073000
499,1718,"Essex County, MA",2017.0,2018.0,57,2772000,56,3182000,1,-410000
500,1718,"Essex County, NJ",2017.0,2018.0,441,10001000,174,4487000,267,5514000
501,1718,"Fairfax County, VA",2017.0,2018.0,614,30704000,480,30110000,134,594000
502,1718,"Fairfield County, CT",2017.0,2018.0,425,25603000,216,20079000,209,5524000
503,1718,"Fannin County, GA",2017.0,2018.0,38,900000,43,1903000,-5,-1003000
504,1718,"Floyd County, GA",2017.0,2018.0,373,10677000,366,10808000,7,-131000
505,1718,"Fort Bend County, TX",2017.0,2018.0,211,8603000,197,7789000,14,814000
506,1718,"Franklin County, OH",2017.0,2018.0,629,18390000,561,16118000,68,2272000
507,1718,"Gilmer County, GA",2017.0,2018.0,201,5789000,263,8877000,-62,-3088000
508,1718,"Glynn County, GA",2017.0,2018.0,262,6994000,298,12105000,-36,-5111000
509,1718,"Gordon County, GA",2017.0,2018.0,113,2562000,171,3928000,-58,-1366000
510,1718,"Greenville County, SC",2017.0,2018.0,519,20375000,536,24708000,-17,-4333000
511,1718,"Guilford County, NC",2017.0,2018.0,456,11026000,237,6189000,219,4837000
512,1718,"Habersham County, GA",2017.0,2018.0,68,1841000,121,3690000,-53,-1849000
513,1718,"Hall County, GA",2017.0,2018.0,3224,94679000,4743,177614000,-1519,-82935000
514,1718,"Hamilton County, OH",2017.0,2018.0,383,11915000,317,10050000,66,1865000
515,1718,"Hamilton County, TN",2017.0,2018.0,577,25156000,599,25466000,-22,-310000
516,1718,"Haralson County, GA",2017.0,2018.0,109,2138000,265,7054000,-156,-4916000
517,1718,"Harris County, TX",2017.0,2018.0,1725,67703000,1454,56749000,271,10954000
518,1718,"Harrison County, MS",2017.0,2018.0,48,1006000,45,957000,3,49000
519,1718,"Hartford County, CT",2017.0,2018.0,238,11345000,108,3597000,130,7748000
520,1718,"Hennepin County, MN",2017.0,2018.0,399,24036000,349,13215000,50,10821000
521,1718,"Henrico County, VA",2017.0,2018.0,293,11634000,216,7297000,77,4337000
522,1718,"Hillsborough County, FL",2017.0,2018.0,1576,50287000,1357,65289000,219,-15002000
523,1718,"Hinds County, MS",2017.0,2018.0,87,2284000,44,957000,43,1327000
524,1718,"Honolulu County, HI",2017.0,2018.0,215,6447000,177,5259000,38,1188000
525,1718,"Horry County, SC",2017.0,2018.0,112,2188000,168,6780000,-56,-4592000
526,1718,"Houston County, GA",2017.0,2018.0,769,20314000,611,13602000,158,6712000
527,1718,"Howard County, MD",2017.0,2018.0,48,2527000,52,1931000,-4,596000
528,1718,"Hudson County, NJ",2017.0,2018.0,265,19318000,202,10227000,63,9091000
529,1718,"Jackson County, GA",2017.0,2018.0,710,20176000,1895,62436000,-1185,-42260000
530,1718,"Jackson County, MO",2017.0,2018.0,95,2962000,73,2356000,22,606000
531,1718,"Jasper County, GA",2017.0,2018.0,56,900000,136,5293000,-80,-4393000
532,1718,"Jefferson County, AL",2017.0,2018.0,1019,39395000,782,30229000,237,9166000
533,1718,"Jefferson County, KY",2017.0,2018.0,468,20820000,323,11449000,145,9371000
534,1718,"Jefferson Parish, LA",2017.0,2018.0,168,3883000,91,1614000,77,2269000
535,1718,"Johnson County, KS",2017.0,2018.0,60,3235000,41,3423000,19,-188000
536,1718,"King County, WA",2017.0,2018.0,689,35936000,1082,63500000,-393,-27564000
537,1718,"Kings County, NY",2017.0,2018.0,1572,48926000,783,32512000,789,16414000
538,1718,"Knox County, TN",2017.0,2018.0,380,14358000,373,14220000,7,138000
539,1718,"Lake County, FL",2017.0,2018.0,143,4032000,147,4909000,-4,-877000
540,1718,"Lake County, IL",2017.0,2018.0,96,5026000,47,3630000,49,1396000
541,1718,"Lamar County, GA",2017.0,2018.0,79,1526000,189,5067000,-110,-3541000
542,1718,"Lee County, AL",2017.0,2018.0,347,10763000,302,10452000,45,311000
543,1718,"Lee County, FL",2017.0,2018.0,410,13181000,326,19903000,84,-6722000
544,1718,"Leon County, FL",2017.0,2018.0,450,16172000,252,9690000,198,6482000
545,1718,"Lexington County, SC",2017.0,2018.0,109,2967000,88,2107000,21,860000
546,1718,"Los Angeles County, CA",2017.0,2018.0,2646,108121000,1828,83951000,818,24170000
547,1718,"Loudoun County, VA",2017.0,2018.0,147,8063000,118,5594000,29,2469000
548,1718,"Lowndes County, GA",2017.0,2018.0,378,7924000,288,5616000,90,2308000
549,1718,"Lumpkin County, GA",2017.0,2018.0,288,7039000,458,18105000,-170,-11066000
550,1718,"Madison County, AL",2017.0,2018.0,342,11192000,362,10961000,-20,231000
551,1718,"Manatee County, FL",2017.0,2018.0,162,4701000,266,22135000,-104,-17434000
552,1718,"Maricopa County, AZ",2017.0,2018.0,1017,44539000,1051,48588000,-34,-4049000
553,1718,"Marion County, IN",2017.0,2018.0,428,9046000,410,9740000,18,-694000
554,1718,"Mecklenburg County, NC",2017.0,2018.0,1545,64081000,1463,74515000,82,-10434000
555,1718,"Mercer County, NJ",2017.0,2018.0,63,2103000,36,1137000,27,966000
556,1718,"Meriwether County, GA",2017.0,2018.0,54,968000,47,972000,7,-4000
557,1718,"Miami, Dade County",2017.0,2018.0,2593,60899000,1127,69969000,1466,-9070000
558,1718,"Middlesex County, MA",2017.0,2018.0,475,26710000,385,19383000,90,7327000
559,1718,"Middlesex County, NJ",2017.0,2018.0,409,18541000,199,6452000,210,12089000
560,1718,"Milwaukee County, WI",2017.0,2018.0,293,6926000,222,6569000,71,357000
561,1718,"Mobile County, AL",2017.0,2018.0,376,8003000,226,5488000,150,2515000
562,1718,"Monmouth County, NJ",2017.0,2018.0,38,1189000,40,2151000,-2,-962000
563,1718,"Monroe County, GA",2017.0,2018.0,85,1917000,161,3775000,-76,-1858000
564,1718,"Monroe County, NY",2017.0,2018.0,141,4579000,115,3060000,26,1519000
565,1718,"Montgomery County, AL",2017.0,2018.0,566,16006000,286,5228000,280,10778000
566,1718,"Montgomery County, MD",2017.0,2018.0,515,24636000,469,19404000,46,5232000
567,1718,"Montgomery County, OH",2017.0,2018.0,43,861000,44,609000,-1,252000
568,1718,"Montgomery County, PA",2017.0,2018.0,125,5478000,132,7936000,-7,-2458000
569,1718,"Montgomery County, TN",2017.0,2018.0,93,1980000,113,2300000,-20,-320000
570,1718,"Morris County, NJ",2017.0,2018.0,71,5009000,42,2934000,29,2075000
571,1718,"Multnomah County, OR",2017.0,2018.0,90,3870000,167,8630000,-77,-4760000
572,1718,"Muscogee County, GA",2017.0,2018.0,1050,26518000,755,19943000,295,6575000
573,1718,"Nassau County, NY",2017.0,2018.0,585,21013000,166,6335000,419,14678000
574,1718,"New Castle County, DE",2017.0,2018.0,70,2192000,53,1675000,17,517000
575,1718,"New Hanover County, NC",2017.0,2018.0,36,1337000,36,4063000,0,-2726000
576,1718,"New Haven County, CT",2017.0,2018.0,226,7452000,115,3782000,111,3670000
577,1718,"New York County, NY",2017.0,2018.0,1074,71582000,862,72856000,212,-1274000
578,1718,"Newton County, GA",2017.0,2018.0,3685,61644000,4898,82691000,-1213,-21047000
579,1718,"Norfolk County, MA",2017.0,2018.0,125,5359000,94,5578000,31,-219000
580,1718,"Norfolk city, VA",2017.0,2018.0,158,3725000,115,1746000,43,1979000
581,1718,"Oakland County, MI",2017.0,2018.0,403,19350000,313,13624000,90,5726000
582,1718,"Oconee County, GA",2017.0,2018.0,219,10233000,366,19138000,-147,-8905000
583,1718,"Okaloosa County, FL",2017.0,2018.0,90,2658000,120,6414000,-30,-3756000
584,1718,"Oklahoma County, OK",2017.0,2018.0,68,2185000,37,2101000,31,84000
585,1718,"Onslow County, NC",2017.0,2018.0,51,1120000,53,771000,-2,349000
586,1718,"Orange County, CA",2017.0,2018.0,700,35532000,568,31841000,132,3691000
587,1718,"Orange County, FL",2017.0,2018.0,1676,46601000,1340,44019000,336,2582000
588,1718,"Orleans Parish, LA",2017.0,2018.0,312,8951000,257,6937000,55,2014000
589,1718,"Osceola County, FL",2017.0,2018.0,153,3630000,157,4143000,-4,-513000
590,1718,"Palm Beach County, FL",2017.0,2018.0,1371,51251000,876,59500000,495,-8249000
591,1718,"Pasco County, FL",2017.0,2018.0,152,4301000,226,7649000,-74,-3348000
592,1718,"Paulding County, GA",2017.0,2018.0,5439,134142000,8683,202070000,-3244,-67928000
593,1718,"Philadelphia County, PA",2017.0,2018.0,543,17423000,442,13465000,101,3958000
594,1718,"Pickens County, GA",2017.0,2018.0,710,23010000,1053,41956000,-343,-18946000
595,1718,"Pierce County, WA",2017.0,2018.0,134,3364000,137,3503000,-3,-139000
596,1718,"Pike County, GA",2017.0,2018.0,44,1234000,182,5758000,-138,-4524000
597,1718,"Pima County, AZ",2017.0,2018.0,102,4607000,130,6232000,-28,-1625000
598,1718,"Pinellas County, FL",2017.0,2018.0,605,22369000,739,35828000,-134,-13459000
599,1718,"Polk County, FL",2017.0,2018.0,283,6070000,294,9069000,-11,-2999000
600,1718,"Polk County, GA",2017.0,2018.0,55,1563000,108,2784000,-53,-1221000
601,1718,"Prince George's County, MD",2017.0,2018.0,573,16378000,414,9155000,159,7223000
602,1718,"Prince William County, VA",2017.0,2018.0,46,2145000,65,2362000,-19,-217000
603,1718,"Pulaski County, AR",2017.0,2018.0,56,2106000,35,1211000,21,895000
604,1718,"Queens County, NY",2017.0,2018.0,1275,30259000,510,12007000,765,18252000
605,1718,"Ramsey County, MN",2017.0,2018.0,76,3091000,119,2774000,-43,317000
606,1718,"Richland County, SC",2017.0,2018.0,503,18204000,421,12745000,82,5459000
607,1718,"Richmond County, GA",2017.0,2018.0,724,16545000,654,14840000,70,1705000
608,1718,"Richmond city, VA",2017.0,2018.0,56,3035000,54,3002000,2,33000
609,1718,"Riverside County, CA",2017.0,2018.0,282,8466000,231,6872000,51,1594000
610,1718,"Rutherford County, TN",2017.0,2018.0,165,4935000,181,6202000,-16,-1267000
611,1718,"Sacramento County, CA",2017.0,2018.0,201,5210000,236,6633000,-35,-1423000
612,1718,"Salt Lake County, UT",2017.0,2018.0,141,5622000,188,7655000,-47,-2033000
613,1718,"San Bernardino County, CA",2017.0,2018.0,197,4546000,201,3611000,-4,935000
614,1718,"San Diego County, CA",2017.0,2018.0,696,26665000,669,27220000,27,-555000
615,1718,"San Francisco County, CA",2017.0,2018.0,228,23657000,300,23093000,-72,564000
616,1718,"San Mateo County, CA",2017.0,2018.0,51,3364000,101,8015000,-50,-4651000
617,1718,"Santa Clara County, CA",2017.0,2018.0,517,30157000,593,33482000,-76,-3325000
618,1718,"Sarasota County, FL",2017.0,2018.0,168,7549000,223,18900000,-55,-11351000
619,1718,"Seminole County, FL",2017.0,2018.0,412,12722000,338,14434000,74,-1712000
620,1718,"Shelby County, AL",2017.0,2018.0,245,10146000,179,7124000,66,3022000
621,1718,"Shelby County, TN",2017.0,2018.0,974,30315000,573,15882000,401,14433000
622,1718,"Snohomish County, WA",2017.0,2018.0,68,2498000,37,1465000,31,1033000
623,1718,"Spalding County, GA",2017.0,2018.0,1359,25028000,2051,40288000,-692,-15260000
624,1718,"Spartanburg County, SC",2017.0,2018.0,49,1226000,93,1968000,-44,-742000
625,1718,"St. Johns County, FL",2017.0,2018.0,166,16092000,379,25558000,-213,-9466000
626,1718,"St. Louis County, MO",2017.0,2018.0,446,14533000,320,12256000,126,2277000
627,1718,"St. Louis city, MO",2017.0,2018.0,81,3821000,40,2035000,41,1786000
628,1718,"St. Lucie County, FL",2017.0,2018.0,154,3696000,149,6817000,5,-3121000
629,1718,"Suffolk County, MA",2017.0,2018.0,367,18659000,261,13626000,106,5033000
630,1718,"Suffolk County, NY",2017.0,2018.0,364,11176000,98,3097000,266,8079000
631,1718,"Tarrant County, TX",2017.0,2018.0,538,19228000,652,23120000,-114,-3892000
632,1718,"Travis County, TX",2017.0,2018.0,697,43141000,528,27726000,169,15415000
633,1718,"Troup County, GA",2017.0,2018.0,223,6402000,158,3000000,65,3402000
634,1718,"Tuscaloosa County, AL",2017.0,2018.0,90,2845000,38,1436000,52,1409000
635,1718,"Upson County, GA",2017.0,2018.0,50,865000,61,1133000,-11,-268000
636,1718,"Virginia Beach city, VA",2017.0,2018.0,229,8894000,141,2834000,88,6060000
637,1718,"Volusia County, FL",2017.0,2018.0,313,8541000,278,10629000,35,-2088000
638,1718,"Wake County, NC",2017.0,2018.0,913,37815000,830,35447000,83,2368000
639,1718,"Walton County, FL",2017.0,2018.0,55,10443000,134,31027000,-79,-20584000
640,1718,"Walton County, GA",2017.0,2018.0,1829,43082000,3657,97682000,-1828,-54600000
641,1718,"Washington County, OR",2017.0,2018.0,52,1977000,45,2575000,7,-598000
642,1718,"Washtenaw County, MI",2017.0,2018.0,104,4030000,97,5720000,7,-1690000
643,1718,"Wayne County, MI",2017.0,2018.0,695,15538000,506,8995000,189,6543000
644,1718,"Westchester County, NY",2017.0,2018.0,386,16769000,168,8199000,218,8570000
645,1718,"White County, GA",2017.0,2018.0,79,2207000,136,4165000,-57,-1958000
646,1718,"Whitfield County, GA",2017.0,2018.0,59,1647000,66,2191000,-7,-544000
647,1718,"Will County, IL",2017.0,2018.0,107,4925000,33,819000,74,4106000
648,1718,"Williamson County, TN",2017.0,2018.0,97,5531000,99,6544000,-2,-1013000
649,1718,"Worcester County, MA",2017.0,2018.0,56,3158000,31,1237000,25,1921000
650,1718,"York County, SC",2017.0,2018.0,82,2674000,88,4100000,-6,-1426000
651,1819,"Aiken County, SC",2018.0,2019.0,33,926000,30,790000,3,136000
652,1819,"Alachua County, FL",2018.0,2019.0,177,6716000,137,5180000,40,1536000
653,1819,"Alameda County, CA",2018.0,2019.0,499,36409000,398,21273000,101,15136000
654,1819,"Alexandria city, VA",2018.0,2019.0,63,7497000,69,3722000,-6,3775000
655,1819,"Allegheny County, PA",2018.0,2019.0,410,16652000,342,12437000,68,4215000
656,1819,"Anderson County, SC",2018.0,2019.0,45,786000,65,2755000,-20,-1969000
657,1819,"Anne Arundel County, MD",2018.0,2019.0,77,4074000,37,1784000,40,2290000
658,1819,"Arapahoe County, CO",2018.0,2019.0,261,10703000,275,10877000,-14,-174000
659,1819,"Arlington County, VA",2018.0,2019.0,153,12804000,144,9160000,9,3644000
660,1819,"Baldwin County, AL",2018.0,2019.0,53,5674000,55,2966000,-2,2708000
661,1819,"Baldwin County, GA",2018.0,2019.0,46,841000,37,633000,9,208000
662,1819,"Baltimore County, MD",2018.0,2019.0,249,12064000,173,5370000,76,6694000
663,1819,"Baltimore city, MD",2018.0,2019.0,292,11519000,191,6967000,101,4552000
664,1819,"Barrow County, GA",2018.0,2019.0,1498,33252000,3029,72638000,-1531,-39386000
665,1819,"Bartow County, GA",2018.0,2019.0,1460,36639000,2672,72652000,-1212,-36013000
666,1819,"Bay County, FL",2018.0,2019.0,267,9201000,202,11264000,65,-2063000
667,1819,"Beaufort County, SC",2018.0,2019.0,221,10421000,424,40216000,-203,-29795000
668,1819,"Bell County, TX",2018.0,2019.0,49,1041000,53,793000,-4,248000
669,1819,"Benton County, AR",2018.0,2019.0,39,2623000,55,3903000,-16,-1280000
670,1819,"Bergen County, NJ",2018.0,2019.0,297,16428000,112,4360000,185,12068000
671,1819,"Berkeley County, SC",2018.0,2019.0,31,1631000,54,2239000,-23,-608000
672,1819,"Bernalillo County, NM",2018.0,2019.0,59,2895000,38,2479000,21,416000
673,1819,"Bexar County, TX",2018.0,2019.0,394,15774000,361,13313000,33,2461000
674,1819,"Bibb County, GA",2018.0,2019.0,1055,28310000,702,16140000,353,12170000
675,1819,"Brevard County, FL",2018.0,2019.0,349,12089000,386,18824000,-37,-6735000
676,1819,"Bronx County, NY",2018.0,2019.0,686,12275000,256,4083000,430,8192000
677,1819,"Broward County, FL",2018.0,2019.0,2735,68442000,1548,64889000,1187,3553000
678,1819,"Bulloch County, GA",2018.0,2019.0,168,3673000,135,3486000,33,187000
679,1819,"Buncombe County, NC",2018.0,2019.0,164,6125000,183,12114000,-19,-5989000
680,1819,"Butts County, GA",2018.0,2019.0,368,6270000,596,14860000,-228,-8590000
681,1819,"Carroll County, GA",2018.0,2019.0,1718,36621000,2206,49114000,-488,-12493000
682,1819,"Charleston County, SC",2018.0,2019.0,471,17414000,530,48250000,-59,-30836000
683,1819,"Chatham County, GA",2018.0,2019.0,1427,37813000,971,32017000,456,5796000
684,1819,"Chester County, PA",2018.0,2019.0,78,5031000,27,1325000,51,3706000
685,1819,"Clark County, NV",2018.0,2019.0,610,19465000,691,23059000,-81,-3594000
686,1819,"Clarke County, GA",2018.0,2019.0,1198,33429000,963,30953000,235,2476000
687,1819,"Collier County, FL",2018.0,2019.0,128,6772000,134,25605000,-6,-18833000
688,1819,"Collin County, TX",2018.0,2019.0,563,29164000,678,30270000,-115,-1106000
689,1819,"Columbia County, GA",2018.0,2019.0,384,13942000,305,10956000,79,2986000
690,1819,"Contra Costa County, CA",2018.0,2019.0,242,13981000,102,5003000,140,8978000
691,1819,"Cook County, IL",2018.0,2019.0,2458,116515000,1551,69929000,907,46586000
692,1819,"Coweta County, GA",2018.0,2019.0,2597,82170000,3861,136105000,-1264,-53935000
693,1819,"Cumberland County, NC",2018.0,2019.0,303,6439000,236,5625000,67,814000
694,1819,"Cuyahoga County, OH",2018.0,2019.0,535,25475000,326,10550000,209,14925000
695,1819,"Dallas County, TX",2018.0,2019.0,1060,51475000,1076,64683000,-16,-13208000
696,1819,"Dane County, WI",2018.0,2019.0,65,3182000,46,2225000,19,957000
697,1819,"Davidson County, TN",2018.0,2019.0,861,45012000,794,39014000,67,5998000
698,1819,"Dawson County, GA",2018.0,2019.0,604,18663000,1183,42429000,-579,-23766000
699,1819,"Denton County, TX",2018.0,2019.0,222,11995000,319,20172000,-97,-8177000
700,1819,"Denver County, CO",2018.0,2019.0,301,15950000,550,46892000,-249,-30942000
701,1819,"District of Columbia, DC",2018.0,2019.0,499,31886000,484,31525000,15,361000
702,1819,"Dougherty County, GA",2018.0,2019.0,461,8418000,298,4386000,163,4032000
703,1819,"DuPage County, IL",2018.0,2019.0,282,14939000,178,8574000,104,6365000
704,1819,"Durham County, NC",2018.0,2019.0,310,12375000,288,13730000,22,-1355000
705,1819,"Duval County, FL",2018.0,2019.0,1289,37142000,1221,43198000,68,-6056000
706,1819,"East Baton Rouge Parish, LA",2018.0,2019.0,152,5068000,114,3108000,38,1960000
707,1819,"El Paso County, CO",2018.0,2019.0,199,5543000,158,3629000,41,1914000
708,1819,"Erie County, NY",2018.0,2019.0,118,2764000,128,1362000,-10,1402000
709,1819,"Escambia County, FL",2018.0,2019.0,300,11792000,305,17052000,-5,-5260000
710,1819,"Essex County, NJ",2018.0,2019.0,535,21779000,232,4724000,303,17055000
711,1819,"Fairfax County, VA",2018.0,2019.0,567,34130000,513,28674000,54,5456000
712,1819,"Fairfield County, CT",2018.0,2019.0,312,30095000,181,12791000,131,17304000
713,1819,"Fannin County, GA",2018.0,2019.0,28,797000,60,3566000,-32,-2769000
714,1819,"Floyd County, GA",2018.0,2019.0,341,10632000,440,11574000,-99,-942000
715,1819,"Fort Bend County, TX",2018.0,2019.0,224,12023000,208,6403000,16,5620000
716,1819,"Franklin County, OH",2018.0,2019.0,526,17711000,493,15985000,33,1726000
717,1819,"Gilmer County, GA",2018.0,2019.0,141,4245000,249,9860000,-108,-5615000
718,1819,"Glynn County, GA",2018.0,2019.0,222,7213000,367,32691000,-145,-25478000
719,1819,"Gordon County, GA",2018.0,2019.0,128,3236000,188,5322000,-60,-2086000
720,1819,"Greenville County, SC",2018.0,2019.0,546,19943000,555,21585000,-9,-1642000
721,1819,"Guilford County, NC",2018.0,2019.0,329,9576000,223,7777000,106,1799000
722,1819,"Habersham County, GA",2018.0,2019.0,106,3823000,180,7963000,-74,-4140000
723,1819,"Hall County, GA",2018.0,2019.0,3070,102637000,4686,187440000,-1616,-84803000
724,1819,"Hamilton County, IN",2018.0,2019.0,59,3041000,40,3422000,19,-381000
725,1819,"Hamilton County, OH",2018.0,2019.0,359,17424000,279,9292000,80,8132000
726,1819,"Hamilton County, TN",2018.0,2019.0,567,19950000,587,26274000,-20,-6324000
727,1819,"Haralson County, GA",2018.0,2019.0,137,3390000,246,6293000,-109,-2903000
728,1819,"Harris County, TX",2018.0,2019.0,1389,59299000,1236,45546000,153,13753000
729,1819,"Hartford County, CT",2018.0,2019.0,173,12690000,135,5313000,38,7377000
730,1819,"Hennepin County, MN",2018.0,2019.0,467,26641000,317,13715000,150,12926000
731,1819,"Henrico County, VA",2018.0,2019.0,116,6188000,88,3046000,28,3142000
732,1819,"Hillsborough County, FL",2018.0,2019.0,1407,48721000,1347,54511000,60,-5790000
733,1819,"Hinds County, MS",2018.0,2019.0,58,1383000,43,522000,15,861000
734,1819,"Honolulu County, HI",2018.0,2019.0,170,6078000,156,6693000,14,-615000
735,1819,"Houston County, GA",2018.0,2019.0,714,17691000,525,11574000,189,6117000
736,1819,"Howard County, MD",2018.0,2019.0,70,4253000,90,4308000,-20,-55000
737,1819,"Hudson County, NJ",2018.0,2019.0,313,19908000,215,14382000,98,5526000
738,1819,"Jackson County, GA",2018.0,2019.0,652,27735000,1779,59636000,-1127,-31901000
739,1819,"Jackson County, MO",2018.0,2019.0,62,2269000,37,1970000,25,299000
740,1819,"Jasper County, GA",2018.0,2019.0,44,807000,135,4377000,-91,-3570000
741,1819,"Jefferson County, AL",2018.0,2019.0,994,43818000,808,34806000,186,9012000
742,1819,"Jefferson County, KY",2018.0,2019.0,343,16411000,339,10976000,4,5435000
743,1819,"Jefferson Parish, LA",2018.0,2019.0,220,4812000,212,5264000,8,-452000
744,1819,"Johnson County, KS",2018.0,2019.0,87,10633000,55,4482000,32,6151000
745,1819,"King County, WA",2018.0,2019.0,661,34970000,965,60782000,-304,-25812000
746,1819,"Kings County, NY",2018.0,2019.0,1701,51373000,808,28468000,893,22905000
747,1819,"Knox County, TN",2018.0,2019.0,347,12912000,389,12891000,-42,21000
748,1819,"Lake County, FL",2018.0,2019.0,73,2038000,59,1344000,14,694000
749,1819,"Lamar County, GA",2018.0,2019.0,74,1839000,228,5963000,-154,-4124000
750,1819,"Lee County, AL",2018.0,2019.0,350,10638000,202,10390000,148,248000
751,1819,"Lee County, FL",2018.0,2019.0,454,15004000,397,25669000,57,-10665000
752,1819,"Leon County, FL",2018.0,2019.0,388,12103000,245,9301000,143,2802000
753,1819,"Lexington County, SC",2018.0,2019.0,82,2602000,45,2278000,37,324000
754,1819,"Los Angeles County, CA",2018.0,2019.0,2554,111377000,1838,78230000,716,33147000
755,1819,"Loudoun County, VA",2018.0,2019.0,125,8118000,100,5110000,25,3008000
756,1819,"Lowndes County, GA",2018.0,2019.0,350,7568000,232,4713000,118,2855000
757,1819,"Lumpkin County, GA",2018.0,2019.0,333,8846000,471,18057000,-138,-9211000
758,1819,"Macomb County, MI",2018.0,2019.0,48,1161000,38,1619000,10,-458000
759,1819,"Madison County, AL",2018.0,2019.0,327,11386000,298,9390000,29,1996000
760,1819,"Manatee County, FL",2018.0,2019.0,140,6411000,233,19003000,-93,-12592000
761,1819,"Maricopa County, AZ",2018.0,2019.0,1167,46357000,1301,71425000,-134,-25068000
762,1819,"Marion County, FL",2018.0,2019.0,92,2813000,82,2495000,10,318000
763,1819,"Marion County, IN",2018.0,2019.0,506,12437000,301,6860000,205,5577000
764,1819,"Mecklenburg County, NC",2018.0,2019.0,1513,67985000,1595,85838000,-82,-17853000
765,1819,"Meriwether County, GA",2018.0,2019.0,42,2082000,84,3102000,-42,-1020000
766,1819,"Miami, Dade County",2018.0,2019.0,2517,63265000,1442,53499000,1075,9766000
767,1819,"Middlesex County, MA",2018.0,2019.0,439,23690000,357,23460000,82,230000
768,1819,"Middlesex County, NJ",2018.0,2019.0,348,13230000,193,7012000,155,6218000
769,1819,"Milwaukee County, WI",2018.0,2019.0,329,11117000,203,5970000,126,5147000
770,1819,"Mobile County, AL",2018.0,2019.0,325,6816000,220,4975000,105,1841000
771,1819,"Monroe County, GA",2018.0,2019.0,97,1763000,209,6535000,-112,-4772000
772,1819,"Monroe County, NY",2018.0,2019.0,126,3075000,80,1787000,46,1288000
773,1819,"Montgomery County, AL",2018.0,2019.0,471,17379000,338,8453000,133,8926000
774,1819,"Montgomery County, MD",2018.0,2019.0,439,24358000,428,22610000,11,1748000
775,1819,"Montgomery County, OH",2018.0,2019.0,65,2019000,51,1259000,14,760000
776,1819,"Montgomery County, PA",2018.0,2019.0,84,4523000,67,3590000,17,933000
777,1819,"Montgomery County, TN",2018.0,2019.0,70,1638000,81,1843000,-11,-205000
778,1819,"Multnomah County, OR",2018.0,2019.0,119,5229000,120,6313000,-1,-1084000
779,1819,"Muscogee County, GA",2018.0,2019.0,960,25350000,733,16855000,227,8495000
780,1819,"Nassau County, NY",2018.0,2019.0,479,18288000,192,6854000,287,11434000
781,1819,"New Castle County, DE",2018.0,2019.0,85,3150000,61,2074000,24,1076000
782,1819,"New Haven County, CT",2018.0,2019.0,172,8867000,98,3202000,74,5665000
783,1819,"New York County, NY",2018.0,2019.0,929,80011000,856,68458000,73,11553000
784,1819,"Newton County, GA",2018.0,2019.0,3690,67027000,4760,87431000,-1070,-20404000
785,1819,"Norfolk County, MA",2018.0,2019.0,67,2687000,73,4916000,-6,-2229000
786,1819,"Norfolk city, VA",2018.0,2019.0,42,1395000,36,835000,6,560000
787,1819,"Oakland County, MI",2018.0,2019.0,582,28142000,304,13823000,278,14319000
788,1819,"Oconee County, GA",2018.0,2019.0,140,6147000,319,18834000,-179,-12687000
789,1819,"Okaloosa County, FL",2018.0,2019.0,176,5467000,192,10845000,-16,-5378000
790,1819,"Oklahoma County, OK",2018.0,2019.0,76,3066000,36,1182000,40,1884000
791,1819,"Onslow County, NC",2018.0,2019.0,60,978000,53,956000,7,22000
792,1819,"Orange County, CA",2018.0,2019.0,644,28720000,487,31746000,157,-3026000
793,1819,"Orange County, FL",2018.0,2019.0,1614,44243000,1329,53564000,285,-9321000
794,1819,"Orleans Parish, LA",2018.0,2019.0,364,10292000,285,8582000,79,1710000
795,1819,"Osceola County, FL",2018.0,2019.0,227,3995000,200,5664000,27,-1669000
796,1819,"Palm Beach County, FL",2018.0,2019.0,1313,51304000,1057,76549000,256,-25245000
797,1819,"Pasco County, FL",2018.0,2019.0,206,8547000,235,8138000,-29,409000
798,1819,"Paulding County, GA",2018.0,2019.0,5122,140567000,8035,198212000,-2913,-57645000
799,1819,"Philadelphia County, PA",2018.0,2019.0,600,19501000,372,14288000,228,5213000
800,1819,"Pickens County, GA",2018.0,2019.0,674,21222000,1087,40080000,-413,-18858000
801,1819,"Pierce County, WA",2018.0,2019.0,154,4900000,116,3162000,38,1738000
802,1819,"Pike County, GA",2018.0,2019.0,66,1344000,210,6322000,-144,-4978000
803,1819,"Pima County, AZ",2018.0,2019.0,39,2165000,44,2011000,-5,154000
804,1819,"Pinellas County, FL",2018.0,2019.0,542,23155000,688,52281000,-146,-29126000
805,1819,"Polk County, FL",2018.0,2019.0,290,7298000,324,9018000,-34,-1720000
806,1819,"Polk County, GA",2018.0,2019.0,70,2108000,165,4036000,-95,-1928000
807,1819,"Prince George's County, MD",2018.0,2019.0,622,18657000,468,13661000,154,4996000
808,1819,"Prince William County, VA",2018.0,2019.0,120,4141000,117,3750000,3,391000
809,1819,"Providence County, RI",2018.0,2019.0,42,1628000,46,1407000,-4,221000
810,1819,"Pulaski County, AR",2018.0,2019.0,86,2245000,38,1467000,48,778000
811,1819,"Queens County, NY",2018.0,2019.0,1094,33331000,467,12267000,627,21064000
812,1819,"Ramsey County, MN",2018.0,2019.0,40,987000,73,1380000,-33,-393000
813,1819,"Richland County, SC",2018.0,2019.0,550,15890000,405,9593000,145,6297000
814,1819,"Richmond County, GA",2018.0,2019.0,714,16414000,554,14134000,160,2280000
815,1819,"Richmond city, VA",2018.0,2019.0,111,4889000,81,4420000,30,469000
816,1819,"Riverside County, CA",2018.0,2019.0,234,8508000,140,4774000,94,3734000
817,1819,"Rutherford County, TN",2018.0,2019.0,170,5632000,152,6526000,18,-894000
818,1819,"Sacramento County, CA",2018.0,2019.0,219,5615000,166,5119000,53,496000
819,1819,"Salt Lake County, UT",2018.0,2019.0,68,2311000,73,6462000,-5,-4151000
820,1819,"San Bernardino County, CA",2018.0,2019.0,129,3115000,120,2413000,9,702000
821,1819,"San Diego County, CA",2018.0,2019.0,776,28551000,766,33591000,10,-5040000
822,1819,"San Francisco County, CA",2018.0,2019.0,224,25133000,247,25357000,-23,-224000
823,1819,"San Mateo County, CA",2018.0,2019.0,137,13095000,107,6621000,30,6474000
824,1819,"Santa Clara County, CA",2018.0,2019.0,509,45832000,619,42771000,-110,3061000
825,1819,"Sarasota County, FL",2018.0,2019.0,123,5777000,151,15460000,-28,-9683000
826,1819,"Seminole County, FL",2018.0,2019.0,403,15326000,296,11053000,107,4273000
827,1819,"Shelby County, AL",2018.0,2019.0,252,10132000,184,7789000,68,2343000
828,1819,"Shelby County, TN",2018.0,2019.0,930,29062000,672,21417000,258,7645000
829,1819,"Spalding County, GA",2018.0,2019.0,1596,28211000,2111,44064000,-515,-15853000
830,1819,"Spartanburg County, SC",2018.0,2019.0,100,3389000,75,2510000,25,879000
831,1819,"St. Johns County, FL",2018.0,2019.0,155,7592000,296,33558000,-141,-25966000
832,1819,"St. Louis County, MO",2018.0,2019.0,450,18696000,264,12069000,186,6627000
833,1819,"St. Louis city, MO",2018.0,2019.0,106,3943000,65,2775000,41,1168000
834,1819,"St. Lucie County, FL",2018.0,2019.0,164,3480000,155,4495000,9,-1015000
835,1819,"Stephens County, GA",2018.0,2019.0,45,672000,60,1685000,-15,-1013000
836,1819,"Suffolk County, MA",2018.0,2019.0,240,14076000,231,12727000,9,1349000
837,1819,"Suffolk County, NY",2018.0,2019.0,428,14158000,183,4772000,245,9386000
838,1819,"Summit County, OH",2018.0,2019.0,57,1087000,57,1124000,0,-37000
839,1819,"Tarrant County, TX",2018.0,2019.0,562,19088000,514,24559000,48,-5471000
840,1819,"Travis County, TX",2018.0,2019.0,429,29241000,622,37610000,-193,-8369000
841,1819,"Troup County, GA",2018.0,2019.0,355,9881000,313,7372000,42,2509000
842,1819,"Tuscaloosa County, AL",2018.0,2019.0,60,1937000,43,1930000,17,7000
843,1819,"Union County, NJ",2018.0,2019.0,58,3741000,37,1311000,21,2430000
844,1819,"Virginia Beach city, VA",2018.0,2019.0,226,11745000,142,6157000,84,5588000
845,1819,"Volusia County, FL",2018.0,2019.0,260,8807000,356,16886000,-96,-8079000
846,1819,"Wake County, NC",2018.0,2019.0,775,32743000,771,36608000,4,-3865000
847,1819,"Walton County, FL",2018.0,2019.0,35,5719000,94,41011000,-59,-35292000
848,1819,"Walton County, GA",2018.0,2019.0,1769,45402000,3736,99013000,-1967,-53611000
849,1819,"Washtenaw County, MI",2018.0,2019.0,50,2904000,33,2096000,17,808000
850,1819,"Wayne County, MI",2018.0,2019.0,551,14466000,472,12191000,79,2275000
851,1819,"Westchester County, NY",2018.0,2019.0,169,9817000,102,5317000,67,4500000
852,1819,"White County, GA",2018.0,2019.0,76,2126000,175,6587000,-99,-4461000
853,1819,"Whitfield County, GA",2018.0,2019.0,100,4103000,85,2708000,15,1395000
854,1819,"Williamson County, TN",2018.0,2019.0,142,10124000,166,10450000,-24,-326000
855,1819,"Williamson County, TX",2018.0,2019.0,36,1592000,49,2510000,-13,-918000
856,1819,"York County, SC",2018.0,2019.0,31,918000,37,1874000,-6,-956000
857,1920,"Aiken County, SC",2019.0,2020.0,57,1660000,32,2219000,25,-559000
858,1920,"Alachua County, FL",2019.0,2020.0,309,11576000,193,7714000,116,3862000
859,1920,"Alameda County, CA",2019.0,2020.0,621,43857000,410,20209000,211,23648000
860,1920,"Alexandria city, VA",2019.0,2020.0,94,7589000,80,4753000,14,2836000
861,1920,"Allegheny County, PA",2019.0,2020.0,476,20425000,389,13709000,87,6716000
862,1920,"Anderson County, SC",2019.0,2020.0,38,1277000,66,5195000,-28,-3918000
863,1920,"Anne Arundel County, MD",2019.0,2020.0,143,5294000,151,4783000,-8,511000
864,1920,"Arapahoe County, CO",2019.0,2020.0,295,9310000,220,11564000,75,-2254000
865,1920,"Arlington County, VA",2019.0,2020.0,153,11541000,112,9448000,41,2093000
866,1920,"Baldwin County, AL",2019.0,2020.0,48,2274000,70,4102000,-22,-1828000
867,1920,"Baldwin County, GA",2019.0,2020.0,109,2600000,122,4805000,-13,-2205000
868,1920,"Baltimore County, MD",2019.0,2020.0,362,10409000,228,7539000,134,2870000
869,1920,"Baltimore city, MD",2019.0,2020.0,277,9165000,230,8986000,47,179000
870,1920,"Barrow County, GA",2019.0,2020.0,1683,41176000,3486,89379000,-1803,-48203000
871,1920,"Bartow County, GA",2019.0,2020.0,1675,38761000,3010,87491000,-1335,-48730000
872,1920,"Bay County, FL",2019.0,2020.0,100,3614000,118,9819000,-18,-6205000
873,1920,"Beaufort County, SC",2019.0,2020.0,217,17613000,486,53861000,-269,-36248000
874,1920,"Bergen County, NJ",2019.0,2020.0,319,18431000,116,5919000,203,12512000
875,1920,"Berkeley County, SC",2019.0,2020.0,56,2623000,36,1419000,20,1204000
876,1920,"Bernalillo County, NM",2019.0,2020.0,50,2293000,42,2462000,8,-169000
877,1920,"Bexar County, TX",2019.0,2020.0,423,13034000,416,22552000,7,-9518000
878,1920,"Bibb County, GA",2019.0,2020.0,1068,28705000,921,18143000,147,10562000
879,1920,"Brevard County, FL",2019.0,2020.0,337,12119000,446,21341000,-109,-9222000
880,1920,"Bronx County, NY",2019.0,2020.0,911,19179000,312,4804000,599,14375000
881,1920,"Broward County, FL",2019.0,2020.0,3008,84173000,1648,64068000,1360,20105000
882,1920,"Bulloch County, GA",2019.0,2020.0,207,4380000,112,2796000,95,1584000
883,1920,"Buncombe County, NC",2019.0,2020.0,160,7338000,273,18843000,-113,-11505000
884,1920,"Butts County, GA",2019.0,2020.0,473,8641000,802,-24372000,-329,33013000
885,1920,"Calhoun County, AL",2019.0,2020.0,46,1128000,37,1264000,9,-136000
886,1920,"Carroll County, GA",2019.0,2020.0,1924,43540000,2797,68814000,-873,-25274000
887,1920,"Charleston County, SC",2019.0,2020.0,443,17467000,598,51605000,-155,-34138000
888,1920,"Chatham County, GA",2019.0,2020.0,1288,40179000,1235,49482000,53,-9303000
889,1920,"Chester County, PA",2019.0,2020.0,51,2494000,40,2167000,11,327000
890,1920,"Clark County, NV",2019.0,2020.0,678,17254000,752,22290000,-74,-5036000
891,1920,"Clarke County, GA",2019.0,2020.0,1253,35697000,1144,40061000,109,-4364000
892,1920,"Clay County, FL",2019.0,2020.0,39,994000,36,1694000,3,-700000
893,1920,"Collier County, FL",2019.0,2020.0,107,14914000,145,43617000,-38,-28703000
894,1920,"Collin County, TX",2019.0,2020.0,448,22808000,615,29932000,-167,-7124000
895,1920,"Columbia County, GA",2019.0,2020.0,398,13630000,441,12858000,-43,772000
896,1920,"Contra Costa County, CA",2019.0,2020.0,122,6774000,38,1883000,84,4891000
897,1920,"Cook County, IL",2019.0,2020.0,2364,114075000,1472,68802000,892,45273000
898,1920,"Coweta County, GA",2019.0,2020.0,2958,101974000,4440,165533000,-1482,-63559000
899,1920,"Cumberland County, NC",2019.0,2020.0,265,6060000,202,3250000,63,2810000
900,1920,"Cuyahoga County, OH",2019.0,2020.0,592,18316000,358,11178000,234,7138000
901,1920,"Dallas County, TX",2019.0,2020.0,1031,67731000,1129,58913000,-98,8818000
902,1920,"Dane County, WI",2019.0,2020.0,79,3531000,40,2008000,39,1523000
903,1920,"Dauphin County, PA",2019.0,2020.0,34,1569000,62,925000,-28,644000
904,1920,"Davidson County, TN",2019.0,2020.0,803,35052000,796,44856000,7,-9804000
905,1920,"Dawson County, GA",2019.0,2020.0,671,21535000,1631,65299000,-960,-43764000
906,1920,"Denton County, TX",2019.0,2020.0,280,11884000,349,17529000,-69,-5645000
907,1920,"Denver County, CO",2019.0,2020.0,313,17089000,422,27773000,-109,-10684000
908,1920,"District of Columbia, DC",2019.0,2020.0,539,36757000,456,28660000,83,8097000
909,1920,"Dougherty County, GA",2019.0,2020.0,515,10730000,272,4448000,243,6282000
910,1920,"DuPage County, IL",2019.0,2020.0,121,6667000,70,5727000,51,940000
911,1920,"Durham County, NC",2019.0,2020.0,292,13455000,266,12163000,26,1292000
912,1920,"Duval County, FL",2019.0,2020.0,1452,55057000,1367,45947000,85,9110000
913,1920,"East Baton Rouge Parish, LA",2019.0,2020.0,198,5998000,142,3453000,56,2545000
914,1920,"El Paso County, CO",2019.0,2020.0,239,6133000,252,9654000,-13,-3521000
915,1920,"El Paso County, TX",2019.0,2020.0,40,1194000,40,711000,0,483000
916,1920,"Erie County, NY",2019.0,2020.0,235,5304000,158,3691000,77,1613000
917,1920,"Escambia County, FL",2019.0,2020.0,292,10179000,328,21098000,-36,-10919000
918,1920,"Essex County, MA",2019.0,2020.0,47,2759000,40,2862000,7,-103000
919,1920,"Essex County, NJ",2019.0,2020.0,590,18160000,183,7829000,407,10331000
920,1920,"Fairfax County, VA",2019.0,2020.0,640,35320000,471,23094000,169,12226000
921,1920,"Fairfield County, CT",2019.0,2020.0,275,20107000,96,5995000,179,14112000
922,1920,"Fannin County, GA",2019.0,2020.0,67,2648000,82,6675000,-15,-4027000
923,1920,"Floyd County, GA",2019.0,2020.0,382,11781000,475,14936000,-93,-3155000
924,1920,"Fort Bend County, TX",2019.0,2020.0,290,11810000,219,8176000,71,3634000
925,1920,"Franklin County, OH",2019.0,2020.0,623,21400000,457,15522000,166,5878000
926,1920,"Gilmer County, GA",2019.0,2020.0,250,8332000,352,19950000,-102,-11618000
927,1920,"Glynn County, GA",2019.0,2020.0,242,27485000,423,35941000,-181,-8456000
928,1920,"Gordon County, GA",2019.0,2020.0,100,3391000,302,11523000,-202,-8132000
929,1920,"Greene County, GA",2019.0,2020.0,38,1650000,144,28602000,-106,-26952000
930,1920,"Greenville County, SC",2019.0,2020.0,520,18702000,570,31429000,-50,-12727000
931,1920,"Guilford County, NC",2019.0,2020.0,342,9558000,312,10331000,30,-773000
932,1920,"Habersham County, GA",2019.0,2020.0,58,1886000,176,6387000,-118,-4501000
933,1920,"Hall County, GA",2019.0,2020.0,2925,99895000,5934,255175000,-3009,-155280000
934,1920,"Hamilton County, IN",2019.0,2020.0,47,2791000,57,3144000,-10,-353000
935,1920,"Hamilton County, OH",2019.0,2020.0,370,15262000,303,11984000,67,3278000
936,1920,"Hamilton County, TN",2019.0,2020.0,582,22427000,654,37700000,-72,-15273000
937,1920,"Haralson County, GA",2019.0,2020.0,115,2241000,294,7016000,-179,-4775000
938,1920,"Harris County, TX",2019.0,2020.0,1524,73296000,1633,61210000,-109,12086000
939,1920,"Hartford County, CT",2019.0,2020.0,198,11744000,133,6680000,65,5064000
940,1920,"Hennepin County, MN",2019.0,2020.0,430,21791000,343,17094000,87,4697000
941,1920,"Henrico County, VA",2019.0,2020.0,110,6547000,103,6283000,7,264000
942,1920,"Hillsborough County, FL",2019.0,2020.0,1387,52644000,1464,76787000,-77,-24143000
943,1920,"Hinds County, MS",2019.0,2020.0,131,3129000,81,1371000,50,1758000
944,1920,"Honolulu County, HI",2019.0,2020.0,164,4899000,124,4345000,40,554000
945,1920,"Horry County, SC",2019.0,2020.0,77,2319000,101,4720000,-24,-2401000
946,1920,"Houston County, GA",2019.0,2020.0,735,18904000,826,21487000,-91,-2583000
947,1920,"Howard County, MD",2019.0,2020.0,55,3495000,39,2364000,16,1131000
948,1920,"Hudson County, NJ",2019.0,2020.0,485,37863000,227,11133000,258,26730000
949,1920,"Jackson County, GA",2019.0,2020.0,733,22359000,2594,88182000,-1861,-65823000
950,1920,"Jackson County, MO",2019.0,2020.0,97,4551000,52,2490000,45,2061000
951,1920,"Jasper County, GA",2019.0,2020.0,45,1241000,194,5934000,-149,-4693000
952,1920,"Jefferson County, AL",2019.0,2020.0,1031,42790000,799,32753000,232,10037000
953,1920,"Jefferson County, CO",2019.0,2020.0,44,2616000,50,3783000,-6,-1167000
954,1920,"Jefferson County, KY",2019.0,2020.0,267,9968000,299,12641000,-32,-2673000
955,1920,"Jefferson Parish, LA",2019.0,2020.0,199,4946000,160,4858000,39,88000
956,1920,"Johnson County, KS",2019.0,2020.0,83,3724000,102,4530000,-19,-806000
957,1920,"Kent County, MI",2019.0,2020.0,129,3962000,92,3023000,37,939000
958,1920,"King County, WA",2019.0,2020.0,772,51879000,1018,66788000,-246,-14909000
959,1920,"Kings County, NY",2019.0,2020.0,1988,82869000,765,24429000,1223,58440000
960,1920,"Knox County, TN",2019.0,2020.0,392,12625000,385,16784000,7,-4159000
961,1920,"Lake County, FL",2019.0,2020.0,165,4173000,158,6151000,7,-1978000
962,1920,"Lake County, IL",2019.0,2020.0,75,4719000,59,4981000,16,-262000
963,1920,"Lamar County, GA",2019.0,2020.0,107,2143000,252,7963000,-145,-5820000
964,1920,"Lee County, AL",2019.0,2020.0,294,10128000,293,20353000,1,-10225000
965,1920,"Lee County, FL",2019.0,2020.0,419,17864000,421,34697000,-2,-16833000
966,1920,"Leon County, FL",2019.0,2020.0,443,19067000,247,8753000,196,10314000
967,1920,"Lexington County, SC",2019.0,2020.0,94,3036000,115,3878000,-21,-842000
968,1920,"Liberty County, GA",2019.0,2020.0,104,1837000,102,2039000,2,-202000
969,1920,"Los Angeles County, CA",2019.0,2020.0,2891,135813000,1750,89076000,1141,46737000
970,1920,"Loudoun County, VA",2019.0,2020.0,200,12447000,186,8213000,14,4234000
971,1920,"Lowndes County, GA",2019.0,2020.0,400,8968000,244,4679000,156,4289000
972,1920,"Lumpkin County, GA",2019.0,2020.0,345,10599000,703,26877000,-358,-16278000
973,1920,"Macomb County, MI",2019.0,2020.0,115,2927000,75,1699000,40,1228000
974,1920,"Madison County, AL",2019.0,2020.0,316,11233000,394,13846000,-78,-2613000
975,1920,"Manatee County, FL",2019.0,2020.0,174,7728000,283,18275000,-109,-10547000
976,1920,"Maricopa County, AZ",2019.0,2020.0,1057,43467000,1173,63913000,-116,-20446000
977,1920,"Marion County, IN",2019.0,2020.0,464,11775000,374,8184000,90,3591000
978,1920,"Mecklenburg County, NC",2019.0,2020.0,1529,81063000,1727,89491000,-198,-8428000
979,1920,"Meriwether County, GA",2019.0,2020.0,45,816000,66,1792000,-21,-976000
980,1920,"Miami, Dade County",2019.0,2020.0,2363,72091000,1310,101852000,1053,-29761000
981,1920,"Middlesex County, MA",2019.0,2020.0,463,28853000,386,23929000,77,4924000
982,1920,"Middlesex County, NJ",2019.0,2020.0,277,10185000,147,4225000,130,5960000
983,1920,"Milwaukee County, WI",2019.0,2020.0,330,9705000,213,3876000,117,5829000
984,1920,"Mobile County, AL",2019.0,2020.0,403,8177000,264,6707000,139,1470000
985,1920,"Monroe County, GA",2019.0,2020.0,54,1280000,287,10998000,-233,-9718000
986,1920,"Monroe County, NY",2019.0,2020.0,179,5322000,107,4005000,72,1317000
987,1920,"Montgomery County, AL",2019.0,2020.0,535,14807000,348,8286000,187,6521000
988,1920,"Montgomery County, MD",2019.0,2020.0,563,32067000,446,21791000,117,10276000
989,1920,"Montgomery County, OH",2019.0,2020.0,79,1657000,41,1379000,38,278000
990,1920,"Montgomery County, PA",2019.0,2020.0,62,4131000,46,3919000,16,212000
991,1920,"Montgomery County, TN",2019.0,2020.0,105,2292000,81,2134000,24,158000
992,1920,"Montgomery County, TX",2019.0,2020.0,40,2690000,39,5407000,1,-2717000
993,1920,"Multnomah County, OR",2019.0,2020.0,99,5832000,130,7116000,-31,-1284000
994,1920,"Muscogee County, GA",2019.0,2020.0,1160,26402000,868,19827000,292,6575000
995,1920,"Nassau County, NY",2019.0,2020.0,625,22991000,187,6499000,438,16492000
996,1920,"New Castle County, DE",2019.0,2020.0,114,4924000,95,2931000,19,1993000
997,1920,"New Hanover County, NC",2019.0,2020.0,44,1383000,58,2651000,-14,-1268000
998,1920,"New Haven County, CT",2019.0,2020.0,136,5835000,95,3711000,41,2124000
999,1920,"New York County, NY",2019.0,2020.0,1337,144393000,709,63251000,628,81142000
1000,1920,"Newton County, GA",2019.0,2020.0,3974,68782000,5499,104151000,-1525,-35369000
1001,1920,"Norfolk County, MA",2019.0,2020.0,94,5580000,43,3136000,51,2444000
1002,1920,"Norfolk city, VA",2019.0,2020.0,110,4735000,59,2416000,51,2319000
1003,1920,"Oakland County, MI",2019.0,2020.0,506,26609000,284,11107000,222,15502000
1004,1920,"Oconee County, GA",2019.0,2020.0,218,9357000,485,26639000,-267,-17282000
1005,1920,"Okaloosa County, FL",2019.0,2020.0,42,2183000,44,3131000,-2,-948000
1006,1920,"Oklahoma County, OK",2019.0,2020.0,43,1318000,54,1318000,-11,0
1007,1920,"Onondaga County, NY",2019.0,2020.0,42,2216000,28,1016000,14,1200000
1008,1920,"Orange County, CA",2019.0,2020.0,653,30601000,487,24822000,166,5779000
1009,1920,"Orange County, FL",2019.0,2020.0,1755,54259000,1288,57817000,467,-3558000
1010,1920,"Orleans Parish, LA",2019.0,2020.0,278,10371000,216,6488000,62,3883000
1011,1920,"Osceola County, FL",2019.0,2020.0,182,3892000,189,7394000,-7,-3502000
1012,1920,"Palm Beach County, FL",2019.0,2020.0,1435,60658000,1143,73202000,292,-12544000
1013,1920,"Pasco County, FL",2019.0,2020.0,128,3901000,184,7102000,-56,-3201000
1014,1920,"Paulding County, GA",2019.0,2020.0,5452,150277000,9087,228287000,-3635,-78010000
1015,1920,"Philadelphia County, PA",2019.0,2020.0,720,24914000,467,15354000,253,9560000
1016,1920,"Pickens County, GA",2019.0,2020.0,701,22617000,1413,59451000,-712,-36834000
1017,1920,"Pierce County, WA",2019.0,2020.0,145,3348000,98,2378000,47,970000
1018,1920,"Pike County, GA",2019.0,2020.0,68,1521000,263,7739000,-195,-6218000
1019,1920,"Pima County, AZ",2019.0,2020.0,31,1595000,67,3936000,-36,-2341000
1020,1920,"Pinellas County, FL",2019.0,2020.0,619,27830000,780,55919000,-161,-28089000
1021,1920,"Polk County, FL",2019.0,2020.0,309,8558000,312,7688000,-3,870000
1022,1920,"Polk County, GA",2019.0,2020.0,110,2909000,207,4323000,-97,-1414000
1023,1920,"Prince George's County, MD",2019.0,2020.0,610,16672000,405,12089000,205,4583000
1024,1920,"Prince William County, VA",2019.0,2020.0,143,4267000,93,3289000,50,978000
1025,1920,"Providence County, RI",2019.0,2020.0,33,1094000,31,1849000,2,-755000
1026,1920,"Pulaski County, AR",2019.0,2020.0,59,1545000,56,1671000,3,-126000
1027,1920,"Queens County, NY",2019.0,2020.0,1375,43820000,435,12039000,940,31781000
1028,1920,"Richland County, SC",2019.0,2020.0,556,18152000,463,12373000,93,5779000
1029,1920,"Richmond County, GA",2019.0,2020.0,797,17670000,720,15300000,77,2370000
1030,1920,"Richmond city, VA",2019.0,2020.0,90,4548000,94,4504000,-4,44000
1031,1920,"Riverside County, CA",2019.0,2020.0,351,9673000,272,8907000,79,766000
1032,1920,"Rutherford County, TN",2019.0,2020.0,195,5754000,233,7335000,-38,-1581000
1033,1920,"Sacramento County, CA",2019.0,2020.0,270,8200000,188,6282000,82,1918000
1034,1920,"Salt Lake County, UT",2019.0,2020.0,181,7835000,177,8895000,4,-1060000
1035,1920,"San Bernardino County, CA",2019.0,2020.0,293,7394000,135,3351000,158,4043000
1036,1920,"San Diego County, CA",2019.0,2020.0,779,28647000,712,29496000,67,-849000
1037,1920,"San Francisco County, CA",2019.0,2020.0,334,54484000,231,19463000,103,35021000
1038,1920,"San Mateo County, CA",2019.0,2020.0,89,13408000,78,5467000,11,7941000
1039,1920,"Santa Clara County, CA",2019.0,2020.0,482,38280000,524,42137000,-42,-3857000
1040,1920,"Sarasota County, FL",2019.0,2020.0,191,9256000,335,37592000,-144,-28336000
1041,1920,"Seminole County, FL",2019.0,2020.0,408,13784000,359,11839000,49,1945000
1042,1920,"Shelby County, AL",2019.0,2020.0,248,9396000,270,13120000,-22,-3724000
1043,1920,"Shelby County, TN",2019.0,2020.0,818,40656000,678,19651000,140,21005000
1044,1920,"Snohomish County, WA",2019.0,2020.0,44,2967000,36,1927000,8,1040000
1045,1920,"Spalding County, GA",2019.0,2020.0,1765,37706000,2327,56409000,-562,-18703000
1046,1920,"Spartanburg County, SC",2019.0,2020.0,41,1887000,72,2979000,-31,-1092000
1047,1920,"St. Johns County, FL",2019.0,2020.0,103,4218000,291,30383000,-188,-26165000
1048,1920,"St. Louis County, MO",2019.0,2020.0,444,15754000,345,16491000,99,-737000
1049,1920,"St. Louis city, MO",2019.0,2020.0,111,5355000,98,2624000,13,2731000
1050,1920,"St. Lucie County, FL",2019.0,2020.0,77,2007000,106,4060000,-29,-2053000
1051,1920,"Stephens County, GA",2019.0,2020.0,45,710000,74,2334000,-29,-1624000
1052,1920,"Suffolk County, MA",2019.0,2020.0,325,21853000,248,14687000,77,7166000
1053,1920,"Suffolk County, NY",2019.0,2020.0,286,9353000,100,3387000,186,5966000
1054,1920,"Summit County, OH",2019.0,2020.0,40,1846000,34,1274000,6,572000
1055,1920,"Tarrant County, TX",2019.0,2020.0,530,20671000,612,22533000,-82,-1862000
1056,1920,"Travis County, TX",2019.0,2020.0,515,37584000,615,33310000,-100,4274000
1057,1920,"Troup County, GA",2019.0,2020.0,323,7535000,381,8636000,-58,-1101000
1058,1920,"Tuscaloosa County, AL",2019.0,2020.0,113,4932000,69,2151000,44,2781000
1059,1920,"Union County, NJ",2019.0,2020.0,59,4739000,34,1469000,25,3270000
1060,1920,"Virginia Beach city, VA",2019.0,2020.0,270,14000000,207,6297000,63,7703000
1061,1920,"Volusia County, FL",2019.0,2020.0,284,6628000,333,14803000,-49,-8175000
1062,1920,"Wake County, NC",2019.0,2020.0,830,35678000,899,40537000,-69,-4859000
1063,1920,"Walton County, FL",2019.0,2020.0,61,14843000,151,53149000,-90,-38306000
1064,1920,"Walton County, GA",2019.0,2020.0,2017,46066000,4283,120291000,-2266,-74225000
1065,1920,"Warren County, OH",2019.0,2020.0,47,3991000,48,3202000,-1,789000
1066,1920,"Washtenaw County, MI",2019.0,2020.0,65,4794000,43,2525000,22,2269000
1067,1920,"Wayne County, MI",2019.0,2020.0,629,13987000,482,10129000,147,3858000
1068,1920,"Westchester County, NY",2019.0,2020.0,316,21786000,118,4906000,198,16880000
1069,1920,"White County, GA",2019.0,2020.0,142,3946000,279,9342000,-137,-5396000
1070,1920,"Whitfield County, GA",2019.0,2020.0,106,2769000,106,3140000,0,-371000
1071,1920,"Williamson County, TN",2019.0,2020.0,132,6461000,196,15217000,-64,-8756000
1072,1920,"Williamson County, TX",2019.0,2020.0,61,2438000,81,3501000,-20,-1063000
1073,1920,"York County, SC",2019.0,2020.0,88,4643000,111,5665000,-23,-1022000
1074,2021,"Aiken County, SC",2020.0,2021.0,46,2707000,58,2585000,-12,122000
1075,2021,"Alachua County, FL",2020.0,2021.0,271,11738000,183,7763000,88,3975000
1076,2021,"Alameda County, CA",2020.0,2021.0,692,42940000,342,19840000,350,23100000
1077,2021,"Alexandria city, VA",2020.0,2021.0,70,6172000,81,4593000,-11,1579000
1078,2021,"Allegheny County, PA",2020.0,2021.0,391,17347000,253,13762000,138,3585000
1079,2021,"Anne Arundel County, MD",2020.0,2021.0,82,9127000,39,1957000,43,7170000
1080,2021,"Arapahoe County, CO",2020.0,2021.0,246,8012000,181,7029000,65,983000
1081,2021,"Arlington County, VA",2020.0,2021.0,152,15980000,107,7721000,45,8259000
1082,2021,"Baldwin County, AL",2020.0,2021.0,100,3386000,192,12155000,-92,-8769000
1083,2021,"Baldwin County, GA",2020.0,2021.0,100,2917000,116,2599000,-16,318000
1084,2021,"Baltimore County, MD",2020.0,2021.0,341,14349000,190,5735000,151,8614000
1085,2021,"Baltimore city, MD",2020.0,2021.0,233,9257000,158,8037000,75,1220000
1086,2021,"Barrow County, GA",2020.0,2021.0,1419,41244000,4082,114164000,-2663,-72920000
1087,2021,"Bartow County, GA",2020.0,2021.0,1628,47720000,2885,84566000,-1257,-36846000
1088,2021,"Bay County, FL",2020.0,2021.0,77,2005000,189,8403000,-112,-6398000
1089,2021,"Beaufort County, SC",2020.0,2021.0,191,14323000,369,56105000,-178,-41782000
1090,2021,"Bell County, TX",2020.0,2021.0,37,923000,38,634000,-1,289000
1091,2021,"Bergen County, NJ",2020.0,2021.0,372,15214000,140,7367000,232,7847000
1092,2021,"Berkeley County, SC",2020.0,2021.0,91,2970000,85,4423000,6,-1453000
1093,2021,"Bernalillo County, NM",2020.0,2021.0,40,1549000,32,1285000,8,264000
1094,2021,"Bexar County, TX",2020.0,2021.0,371,12284000,284,13609000,87,-1325000
1095,2021,"Bibb County, GA",2020.0,2021.0,1086,27283000,1062,24884000,24,2399000
1096,2021,"Boulder County, CO",2020.0,2021.0,46,2937000,51,4558000,-5,-1621000
1097,2021,"Brevard County, FL",2020.0,2021.0,290,10081000,320,16751000,-30,-6670000
1098,2021,"Bronx County, NY",2020.0,2021.0,701,19223000,189,3399000,512,15824000
1099,2021,"Broward County, FL",2020.0,2021.0,3038,91920000,1616,81305000,1422,10615000
1100,2021,"Bulloch County, GA",2020.0,2021.0,217,4629000,180,5427000,37,-798000
1101,2021,"Buncombe County, NC",2020.0,2021.0,105,6206000,150,25798000,-45,-19592000
1102,2021,"Butts County, GA",2020.0,2021.0,388,14152000,818,22169000,-430,-8017000
1103,2021,"Calhoun County, AL",2020.0,2021.0,34,682000,32,1261000,2,-579000
1104,2021,"Carroll County, GA",2020.0,2021.0,1727,40388000,3230,81832000,-1503,-41444000
1105,2021,"Catoosa County, GA",2020.0,2021.0,35,979000,36,1700000,-1,-721000
1106,2021,"Charleston County, SC",2020.0,2021.0,414,23796000,646,70420000,-232,-46624000
1107,2021,"Chatham County, GA",2020.0,2021.0,1176,36402000,1224,51333000,-48,-14931000
1108,2021,"Chesterfield County, VA",2020.0,2021.0,42,1609000,34,1375000,8,234000
1109,2021,"Clark County, NV",2020.0,2021.0,926,25514000,735,25674000,191,-160000
1110,2021,"Clarke County, GA",2020.0,2021.0,1329,37374000,1122,46100000,207,-8726000
1111,2021,"Collier County, FL",2020.0,2021.0,85,7802000,119,22497000,-34,-14695000
1112,2021,"Collin County, TX",2020.0,2021.0,491,23357000,633,31640000,-142,-8283000
1113,2021,"Columbia County, GA",2020.0,2021.0,377,16548000,407,15322000,-30,1226000
1114,2021,"Contra Costa County, CA",2020.0,2021.0,212,13830000,130,10693000,82,3137000
1115,2021,"Cook County, IL",2020.0,2021.0,2622,149423000,1375,69232000,1247,80191000
1116,2021,"Coweta County, GA",2020.0,2021.0,2640,95703000,4666,175832000,-2026,-80129000
1117,2021,"Cumberland County, NC",2020.0,2021.0,256,5964000,185,4232000,71,1732000
1118,2021,"Cuyahoga County, OH",2020.0,2021.0,572,19135000,283,12743000,289,6392000
1119,2021,"Dallas County, TX",2020.0,2021.0,1048,52869000,1077,52267000,-29,602000
1120,2021,"Dane County, WI",2020.0,2021.0,84,4553000,33,2523000,51,2030000
1121,2021,"Davidson County, TN",2020.0,2021.0,858,39104000,803,53238000,55,-14134000
1122,2021,"Dawson County, GA",2020.0,2021.0,714,29925000,1564,73869000,-850,-43944000
1123,2021,"Denton County, TX",2020.0,2021.0,344,15193000,466,28169000,-122,-12976000
1124,2021,"Denver County, CO",2020.0,2021.0,304,22013000,474,35048000,-170,-13035000
1125,2021,"District of Columbia, DC",2020.0,2021.0,600,46977000,452,27833000,148,19144000
1126,2021,"Dougherty County, GA",2020.0,2021.0,455,9134000,303,5503000,152,3631000
1127,2021,"DuPage County, IL",2020.0,2021.0,296,17488000,120,5981000,176,11507000
1128,2021,"Durham County, NC",2020.0,2021.0,270,13269000,225,18026000,45,-4757000
1129,2021,"Duval County, FL",2020.0,2021.0,1396,49813000,1373,86984000,23,-37171000
1130,2021,"East Baton Rouge Parish, LA",2020.0,2021.0,90,4234000,49,1911000,41,2323000
1131,2021,"El Paso County, CO",2020.0,2021.0,250,6894000,243,9535000,7,-2641000
1132,2021,"El Paso County, TX",2020.0,2021.0,75,2035000,89,2194000,-14,-159000
1133,2021,"Erie County, NY",2020.0,2021.0,158,3962000,100,2748000,58,1214000
1134,2021,"Escambia County, FL",2020.0,2021.0,291,8093000,240,11538000,51,-3445000
1135,2021,"Essex County, NJ",2020.0,2021.0,585,21288000,243,6440000,342,14848000
1136,2021,"Fairfax County, VA",2020.0,2021.0,593,41828000,382,20858000,211,20970000
1137,2021,"Fairfield County, CT",2020.0,2021.0,141,16589000,80,13662000,61,2927000
1138,2021,"Floyd County, GA",2020.0,2021.0,401,13254000,584,20737000,-183,-7483000
1139,2021,"Fort Bend County, TX",2020.0,2021.0,297,15453000,324,15674000,-27,-221000
1140,2021,"Franklin County, OH",2020.0,2021.0,554,26611000,409,15167000,145,11444000
1141,2021,"Gilmer County, GA",2020.0,2021.0,150,5115000,303,14542000,-153,-9427000
1142,2021,"Glynn County, GA",2020.0,2021.0,234,9405000,464,33370000,-230,-23965000
1143,2021,"Gordon County, GA",2020.0,2021.0,127,4023000,289,9210000,-162,-5187000
1144,2021,"Greenville County, SC",2020.0,2021.0,439,19524000,641,29046000,-202,-9522000
1145,2021,"Guilford County, NC",2020.0,2021.0,338,12015000,263,10123000,75,1892000
1146,2021,"Habersham County, GA",2020.0,2021.0,70,2201000,166,7839000,-96,-5638000
1147,2021,"Hall County, GA",2020.0,2021.0,3101,112848000,6271,280210000,-3170,-167362000
1148,2021,"Hamilton County, IN",2020.0,2021.0,41,2255000,39,4678000,2,-2423000
1149,2021,"Hamilton County, OH",2020.0,2021.0,369,14175000,275,10674000,94,3501000
1150,2021,"Hamilton County, TN",2020.0,2021.0,590,22137000,667,37393000,-77,-15256000
1151,2021,"Haralson County, GA",2020.0,2021.0,121,3304000,337,10921000,-216,-7617000
1152,2021,"Harris County, TX",2020.0,2021.0,1316,58584000,1450,51639000,-134,6945000
1153,2021,"Hartford County, CT",2020.0,2021.0,270,12674000,148,6422000,122,6252000
1154,2021,"Hennepin County, MN",2020.0,2021.0,449,23901000,273,13830000,176,10071000
1155,2021,"Henrico County, VA",2020.0,2021.0,76,3929000,50,4710000,26,-781000
1156,2021,"Hillsborough County, FL",2020.0,2021.0,1375,47180000,1507,67736000,-132,-20556000
1157,2021,"Hinds County, MS",2020.0,2021.0,64,1535000,35,1080000,29,455000
1158,2021,"Honolulu County, HI",2020.0,2021.0,266,8140000,175,5201000,91,2939000
1159,2021,"Horry County, SC",2020.0,2021.0,75,2041000,118,7103000,-43,-5062000
1160,2021,"Houston County, GA",2020.0,2021.0,648,18874000,770,19439000,-122,-565000
1161,2021,"Howard County, MD",2020.0,2021.0,103,4682000,71,4180000,32,502000
1162,2021,"Hudson County, NJ",2020.0,2021.0,323,20965000,175,9303000,148,11662000
1163,2021,"Jackson County, GA",2020.0,2021.0,772,23601000,2706,101274000,-1934,-77673000
1164,2021,"Jackson County, MO",2020.0,2021.0,69,3075000,38,1199000,31,1876000
1165,2021,"Jasper County, GA",2020.0,2021.0,50,1958000,190,7520000,-140,-5562000
1166,2021,"Jefferson County, AL",2020.0,2021.0,906,31373000,817,35473000,89,-4100000
1167,2021,"Jefferson County, CO",2020.0,2021.0,97,3988000,107,7937000,-10,-3949000
1168,2021,"Jefferson County, KY",2020.0,2021.0,383,15342000,266,10945000,117,4397000
1169,2021,"Jefferson Parish, LA",2020.0,2021.0,64,1387000,40,895000,24,492000
1170,2021,"Johnson County, KS",2020.0,2021.0,49,2564000,40,6145000,9,-3581000
1171,2021,"Kent County, MI",2020.0,2021.0,53,2230000,43,2540000,10,-310000
1172,2021,"King County, WA",2020.0,2021.0,904,76411000,862,62009000,42,14402000
1173,2021,"Kings County, NY",2020.0,2021.0,2201,94743000,641,25770000,1560,68973000
1174,2021,"Knox County, TN",2020.0,2021.0,313,11888000,338,21496000,-25,-9608000
1175,2021,"Lake County, FL",2020.0,2021.0,96,3091000,93,4534000,3,-1443000
1176,2021,"Lake County, IL",2020.0,2021.0,121,9027000,31,1766000,90,7261000
1177,2021,"Lamar County, GA",2020.0,2021.0,69,1800000,411,12467000,-342,-10667000
1178,2021,"Lee County, AL",2020.0,2021.0,282,9474000,292,11512000,-10,-2038000
1179,2021,"Lee County, FL",2020.0,2021.0,468,21470000,437,30790000,31,-9320000
1180,2021,"Leon County, FL",2020.0,2021.0,528,16695000,357,11824000,171,4871000
1181,2021,"Lexington County, SC",2020.0,2021.0,101,4026000,87,3417000,14,609000
1182,2021,"Liberty County, GA",2020.0,2021.0,140,2631000,148,2714000,-8,-83000
1183,2021,"Los Angeles County, CA",2020.0,2021.0,3723,183231000,1755,93588000,1968,89643000
1184,2021,"Loudoun County, VA",2020.0,2021.0,134,8600000,163,6917000,-29,1683000
1185,2021,"Lowndes County, GA",2020.0,2021.0,402,8886000,297,6190000,105,2696000
1186,2021,"Lumpkin County, GA",2020.0,2021.0,271,7410000,587,23516000,-316,-16106000
1187,2021,"Madison County, AL",2020.0,2021.0,316,13467000,406,14316000,-90,-849000
1188,2021,"Madison County, GA",2020.0,2021.0,43,1029000,98,3795000,-55,-2766000
1189,2021,"Manatee County, FL",2020.0,2021.0,176,7994000,358,38039000,-182,-30045000
1190,2021,"Maricopa County, AZ",2020.0,2021.0,1316,53672000,1117,56668000,199,-2996000
1191,2021,"Marion County, FL",2020.0,2021.0,95,2126000,139,5166000,-44,-3040000
1192,2021,"Marion County, IN",2020.0,2021.0,569,18777000,328,7416000,241,11361000
1193,2021,"Mecklenburg County, NC",2020.0,2021.0,1457,71704000,1301,91122000,156,-19418000
1194,2021,"Mercer County, NJ",2020.0,2021.0,64,2785000,37,2391000,27,394000
1195,2021,"Meriwether County, GA",2020.0,2021.0,40,1300000,52,3365000,-12,-2065000
1196,2021,"Miami, Dade County",2020.0,2021.0,2459,81673000,1383,95975000,1076,-14302000
1197,2021,"Middlesex County, MA",2020.0,2021.0,583,35956000,388,21712000,195,14244000
1198,2021,"Middlesex County, NJ",2020.0,2021.0,301,12221000,162,6594000,139,5627000
1199,2021,"Milwaukee County, WI",2020.0,2021.0,438,12254000,190,4473000,248,7781000
1200,2021,"Mobile County, AL",2020.0,2021.0,334,6518000,251,8413000,83,-1895000
1201,2021,"Monroe County, GA",2020.0,2021.0,57,1249000,285,9179000,-228,-7930000
1202,2021,"Monroe County, NY",2020.0,2021.0,162,4557000,85,3048000,77,1509000
1203,2021,"Montgomery County, AL",2020.0,2021.0,536,17242000,343,9180000,193,8062000
1204,2021,"Montgomery County, MD",2020.0,2021.0,585,28920000,373,17659000,212,11261000
1205,2021,"Montgomery County, OH",2020.0,2021.0,51,1265000,44,1412000,7,-147000
1206,2021,"Montgomery County, PA",2020.0,2021.0,80,4870000,61,3923000,19,947000
1207,2021,"Montgomery County, TN",2020.0,2021.0,86,2444000,95,2062000,-9,382000
1208,2021,"Multnomah County, OR",2020.0,2021.0,111,6135000,149,8661000,-38,-2526000
1209,2021,"Muscogee County, GA",2020.0,2021.0,1071,26313000,813,18413000,258,7900000
1210,2021,"Nassau County, NY",2020.0,2021.0,390,15827000,100,3342000,290,12485000
1211,2021,"New Castle County, DE",2020.0,2021.0,92,4007000,54,2132000,38,1875000
1212,2021,"New Hanover County, NC",2020.0,2021.0,41,1698000,55,4480000,-14,-2782000
1213,2021,"New Haven County, CT",2020.0,2021.0,222,8664000,115,4798000,107,3866000
1214,2021,"New York County, NY",2020.0,2021.0,1287,118480000,733,57409000,554,61071000
1215,2021,"Newton County, GA",2020.0,2021.0,3954,77508000,5773,118824000,-1819,-41316000
1216,2021,"Norfolk County, MA",2020.0,2021.0,131,7731000,85,5885000,46,1846000
1217,2021,"Norfolk city, VA",2020.0,2021.0,165,9496000,105,2521000,60,6975000
1218,2021,"Oakland County, MI",2020.0,2021.0,428,18070000,264,19181000,164,-1111000
1219,2021,"Oconee County, GA",2020.0,2021.0,149,6987000,438,25926000,-289,-18939000
1220,2021,"Okaloosa County, FL",2020.0,2021.0,98,4336000,88,5496000,10,-1160000
1221,2021,"Oklahoma County, OK",2020.0,2021.0,114,3065000,87,2616000,27,449000
1222,2021,"Onslow County, NC",2020.0,2021.0,46,908000,38,1055000,8,-147000
1223,2021,"Orange County, CA",2020.0,2021.0,661,41158000,480,28103000,181,13055000
1224,2021,"Orange County, FL",2020.0,2021.0,1884,63968000,1376,49624000,508,14344000
1225,2021,"Orange County, NC",2020.0,2021.0,66,3762000,71,4238000,-5,-476000
1226,2021,"Orleans Parish, LA",2020.0,2021.0,293,8695000,243,9557000,50,-862000
1227,2021,"Osceola County, FL",2020.0,2021.0,153,3965000,214,7038000,-61,-3073000
1228,2021,"Palm Beach County, FL",2020.0,2021.0,1384,50729000,1033,85895000,351,-35166000
1229,2021,"Pasco County, FL",2020.0,2021.0,179,6946000,311,14515000,-132,-7569000
1230,2021,"Paulding County, GA",2020.0,2021.0,5507,153160000,9309,251978000,-3802,-98818000
1231,2021,"Philadelphia County, PA",2020.0,2021.0,772,32918000,385,17399000,387,15519000
1232,2021,"Pickens County, GA",2020.0,2021.0,760,25910000,1327,63028000,-567,-37118000
1233,2021,"Pierce County, WA",2020.0,2021.0,132,5298000,163,6259000,-31,-961000
1234,2021,"Pike County, GA",2020.0,2021.0,61,1037000,305,9970000,-244,-8933000
1235,2021,"Pima County, AZ",2020.0,2021.0,81,4775000,104,5687000,-23,-912000
1236,2021,"Pinellas County, FL",2020.0,2021.0,564,26750000,884,77779000,-320,-51029000
1237,2021,"Polk County, FL",2020.0,2021.0,329,7609000,418,10972000,-89,-3363000
1238,2021,"Polk County, GA",2020.0,2021.0,66,1833000,165,4556000,-99,-2723000
1239,2021,"Prince George's County, MD",2020.0,2021.0,560,19753000,279,6988000,281,12765000
1240,2021,"Prince William County, VA",2020.0,2021.0,69,3219000,61,2239000,8,980000
1241,2021,"Pulaski County, AR",2020.0,2021.0,82,2885000,44,1579000,38,1306000
1242,2021,"Putnam County, GA",2020.0,2021.0,38,2470000,66,7739000,-28,-5269000
1243,2021,"Queens County, NY",2020.0,2021.0,1510,51413000,353,9827000,1157,41586000
1244,2021,"Richland County, SC",2020.0,2021.0,476,16198000,371,10326000,105,5872000
1245,2021,"Richmond County, GA",2020.0,2021.0,752,18546000,686,16425000,66,2121000
1246,2021,"Richmond city, VA",2020.0,2021.0,103,4980000,54,3240000,49,1740000
1247,2021,"Riverside County, CA",2020.0,2021.0,338,15541000,238,11052000,100,4489000
1248,2021,"Rutherford County, TN",2020.0,2021.0,179,4587000,221,7142000,-42,-2555000
1249,2021,"Sacramento County, CA",2020.0,2021.0,224,6482000,130,3953000,94,2529000
1250,2021,"Salt Lake County, UT",2020.0,2021.0,248,9832000,272,17174000,-24,-7342000
1251,2021,"San Bernardino County, CA",2020.0,2021.0,267,7609000,170,4200000,97,3409000
1252,2021,"San Diego County, CA",2020.0,2021.0,778,34673000,605,29611000,173,5062000
1253,2021,"San Francisco County, CA",2020.0,2021.0,336,76793000,248,27732000,88,49061000
1254,2021,"San Mateo County, CA",2020.0,2021.0,111,13246000,91,7104000,20,6142000
1255,2021,"Santa Clara County, CA",2020.0,2021.0,619,66092000,383,26345000,236,39747000
1256,2021,"Sarasota County, FL",2020.0,2021.0,217,14928000,401,40553000,-184,-25625000
1257,2021,"Seminole County, FL",2020.0,2021.0,317,11269000,311,13150000,6,-1881000
1258,2021,"Shelby County, AL",2020.0,2021.0,178,7459000,175,8709000,3,-1250000
1259,2021,"Shelby County, TN",2020.0,2021.0,842,28611000,479,14891000,363,13720000
1260,2021,"Snohomish County, WA",2020.0,2021.0,107,5474000,90,3807000,17,1667000
1261,2021,"Somerset County, NJ",2020.0,2021.0,40,2496000,34,1578000,6,918000
1262,2021,"Spalding County, GA",2020.0,2021.0,1432,28781000,2489,63660000,-1057,-34879000
1263,2021,"Spartanburg County, SC",2020.0,2021.0,95,2711000,117,5633000,-22,-2922000
1264,2021,"St. Johns County, FL",2020.0,2021.0,170,8629000,396,62204000,-226,-53575000
1265,2021,"St. Louis County, MO",2020.0,2021.0,485,24414000,232,9903000,253,14511000
1266,2021,"St. Louis city, MO",2020.0,2021.0,133,5882000,95,3615000,38,2267000
1267,2021,"St. Lucie County, FL",2020.0,2021.0,100,2718000,98,5438000,2,-2720000
1268,2021,"Stephens County, GA",2020.0,2021.0,45,877000,104,4445000,-59,-3568000
1269,2021,"Suffolk County, MA",2020.0,2021.0,447,26968000,241,16649000,206,10319000
1270,2021,"Suffolk County, NY",2020.0,2021.0,333,11477000,75,3690000,258,7787000
1271,2021,"Tarrant County, TX",2020.0,2021.0,518,21514000,570,25215000,-52,-3701000
1272,2021,"Travis County, TX",2020.0,2021.0,557,31346000,515,35857000,42,-4511000
1273,2021,"Troup County, GA",2020.0,2021.0,336,7485000,401,12318000,-65,-4833000
1274,2021,"Tuscaloosa County, AL",2020.0,2021.0,42,1062000,40,1491000,2,-429000
1275,2021,"Union County, NJ",2020.0,2021.0,75,2890000,32,2140000,43,750000
1276,2021,"Upson County, GA",2020.0,2021.0,72,1880000,172,4470000,-100,-2590000
1277,2021,"Virginia Beach city, VA",2020.0,2021.0,244,15200000,133,5270000,111,9930000
1278,2021,"Volusia County, FL",2020.0,2021.0,218,7448000,339,18896000,-121,-11448000
1279,2021,"Wake County, NC",2020.0,2021.0,835,38409000,808,40206000,27,-1797000
1280,2021,"Walton County, FL",2020.0,2021.0,58,9723000,227,99456000,-169,-89733000
1281,2021,"Walton County, GA",2020.0,2021.0,1848,51637000,4571,143339000,-2723,-91702000
1282,2021,"Washington County, OR",2020.0,2021.0,49,3027000,41,1500000,8,1527000
1283,2021,"Washtenaw County, MI",2020.0,2021.0,123,6738000,50,2690000,73,4048000
1284,2021,"Wayne County, MI",2020.0,2021.0,692,19498000,522,9828000,170,9670000
1285,2021,"Westchester County, NY",2020.0,2021.0,230,17850000,82,4503000,148,13347000
1286,2021,"White County, GA",2020.0,2021.0,43,1555000,147,6491000,-104,-4936000
1287,2021,"Whitfield County, GA",2020.0,2021.0,98,3071000,93,2994000,5,77000
1288,2021,"Williamson County, TN",2020.0,2021.0,117,7466000,150,11446000,-33,-3980000
1289,2021,"Williamson County, TX",2020.0,2021.0,32,1718000,80,6040000,-48,-4322000
1290,2021,"York County, SC",2020.0,2021.0,73,3101000,111,4697000,-38,-1596000
